المقابل باللغة الأنجلزية	المقابل باللغة الفرنسية	المصطلح
abberviation	abréviation	اختزال
Abduction	Abduction	انتفاخ الأوتار الصوتية
ablative	ablatif	حالة المجاوزة
ablaut	ablaut/ alternance؛ permutation vocalique	تعاقب المصوتات تعاقب الحركات
abnormal vowel	voyelle neutre	مصوت متوسط
abrupt	interrompu	حبسي،منقطع
absolute finale	finale absolue	موضع الوقف
absolute negation	négation absolue	نفي مطلق
absorption	assimilation total	تماثل (في مقابل التجانس)
abstatct noun	nom abstrait	اسم معنى(في مقابل اسم عين)
abstaract sound	Son abstrait	صوت مجرد
Abusive language	Langage abusif	لغة مبتذلة
accent	accent	نبر
accentology	accentologie	علم النبر
accentual group	Groupe accentuel	مجموعة نبرية
accentuel system	système accentuel	نظام نبري
accentual unit	unité accentuelle	وحدة نبرية
accentuation	accentuation	تنبير
acceptability	acceptabilité	استحسان
accessory verb	auxiliaire	فعل مساعد( الأفعال الناقصة والنواسخ)
accidence	fléxion	عوارض التصرف
accommodation	assimilation	تجانس(مضارغة)
accusative	accusatif	صوتي فزيائي
acoustique	acoustique	صفات صوتية
acoustic features	traits acoustique	صفات صوتية فزيائية
acoustic filter	filtre acoustique	راشح صوتي
acoustic formants	formants acoustiques	مكونات صوتية فزيائية
acoustician	acoustician	عالم الصوت
acoustic image	image acoustique	صورة سمعية للصوت
acoustics	phonétique acoustique	عالم الأصوات الفزيائي
acoustics	acoustique ؛phonétique acoustique	علم الصوت الفزيائي (دراسة الأصوات من الناحية الفزيائية)
acquisition (linguistic)	acquisition (linguistique)	اكتساب (اللغة)
acronym	acronym ؛abréviation	مختزل نحتي
acrophony	acrophonie	تسمية بالأول
action noun	nom d’action	مصدر
active articulator	organe phonateur actif	عضو النطق المتحرك
active activity	cavité activité	تجويف صاد
active voice	voix active	حالة المبني للمعلوم
actor	actant	فاعل حقيقي
actor-action-goal	agent-action-but	فاعل/فعل/فعل/غاية
actualization	actualisation ؛réalisation	تأدية الحرف إخراج الحروف في التراث)
acute accent	accent aigu/clair	تنغيم حاد
acute phoneme	phonème aigu ;phonème clair	وحدة صوتية حادة
Adam’s apple	pomme d’Adam	حَرْقَدَة
addition	addition	إقحام صوت(في الصوتيات)
additive allomorph	allomorphe supplémentaire	بدل صرفي إضافي
additive clause	proposition	جملة زائدة
adress	terme d’adresse	مخاطبة
adressee	interlocuteur ; allocataire ; destinataire	مخاطب
addresser	destinateur	مرسل(مخاطب ،مبلغ)
adduction	adduction	انقباض(الأوتار الصوتية)
adequacy	adéquation	استيفاء
adherent active	adjectif (qualificatif) épithète	نعت،صفة
ad hoc (law)	régle ad hoc	قاعدة مخصومة
adjacency	adjacence	اتصال
adjectival	adjectival	نعتي،وصفي
adjectival clause	proposition adjectival	جملة وصفية
adjectival construction	construction adjectival	تركيب نعتي
adjectival clause	syntagme adjectival	جملة وصفية
adjectif compement	prédicat adjectif ; adjectif attribut	تركيب نعتي
adjectif prdicate	attribut	خبر وصفي
adjoining ;adjunction	adjonction	إلحاق
adjunct(word)	adjoint ;expansion	فضلة (في مقابل العمدة)
adnominal	adonimal	مخصص الاسم منه المضاف إليه)
adoptive form	forme hypercorrecte	ضرب مغلوط التصحيح
adstratum	adstrat	لغة طارئة
adverbe	adverbe	ظرف
adverbial clause	proposition adverbial	جملة قرينة فضلية
adverbialization	adverbialisation	تحويل إلى قرينة فضلية
adversative clause	proposition indiquant l’opposition	جملة استدراكية
adversative conjonction	conjonction adversative	أداة استدراك
aesthetic opposition	opposition	تقابل جمالي
affective	affectif	وجداني
affiliation	apparentement de langues	قرابة لغوية  نسب لغوي
affinity	affinité linguistique	تشابه
affirmation	affirmation	إثبات
affix	affixe	زائدة
affixation	affixation	زيادة (منها الإلحاق)
affix cliping	fausse ségmentation	تقطيع خاطئ
affixing language	langue flexionnelle ; langue agglutinante	لغة ذات زوائد
affricate	affriquée	معطش (شديد مرخي)
affrication	affrication	تعطيش (ترخية )
agent	agent	فاعل
agglomerting language	langue agglutinative	لغة مزجية
agglomoeration agglutination	agglutination	تركيب مزجي
aggregative compound	mot composé(ex :titres dans journaux)	كلمة مركبة
agnate sentence	phrase d’agnat (phrases bien construites)	جمل أصول وفروع
agnosia	agnosie	عمه
agrammaticality	agrammaticalité	عدم الاستقامة  (عدم السلامة في اللحن)
agrammatism	agrammatisme	مصاباة أوعمه التراكيب (عدم القدرة على الكلام السليم من حيث التركيب)
agraphia	agraphie	عمه الكتابة (عدم القدرة علة الكتابة)
agreement	accord grammatical	توافق
air-stream	écoulement de l’air	مجرى الهواء
air-strean mechanisme	mécanisme d’ecoulement de l’air	كيفية مجرى الهواء
aksouma	impression acoustique	انطباع سمعي للصوت
akume	akuéme	مميز أدني لصوت الفرد
alexia	alexie	عمه القراءة
algorithm	alforithme	خوارزمية
alienism	amprunt ;interférence	دخيل
alienword	emprunt	كلمة دخيلة
allegro forms	formes contractées	صيغ مختزلة (في النطق)
alliteration	alliteration	جناس استهلالي
allochrone	apposition circonflexe	بدل مدي
allocution	allocution	خطاب
allograph	allograph	بدل خطي
allomorph	allomorph	بدل صرفي
allophone	allophone	يدل صوتي  (وجه أداء)
allophonic analogy	analogie allophonique	قياس البدائل الصوتية  (شبه الأصوات)
allophonic change	changement allophonique	تحول صوتي
allophonic confusion	confusion allophonique	خلط صوتي
allophonic variant	variante allophonique	بدل صوتي
alloseme	alloséme	بدل معنوي
allotagma	variante non-distinctive d’un tagmème	بدل تاكميم
allotone	allotone	بدل نغمي
alphabet	alphabet	ألفباء
alphabetic writing	écriture alphabétique	كتابة ألفبائية
alphabetography	étude de l’écriture alphabétique	دراسة الكتابة الألفبائية
alteration(meaning)	changement sémantique	تحول دلالي
alternation	alternance	تعاقب
alternation change	alternance	تحول بالتعاقب
alternative form	forme alternante	بدل التعاقب
alveo-dental	alvéo-dental	نطعي أسناني
alveolar	alvéolaire	نطعي
alveolar ridge ;alveolum	alvéoles	نطع
amalgam	amalgame	امتزاج
amalgamting language	langue flexionnelle ;langue amalgamante	لغة مزجية
ambiguity	ambiguité	التباس
amblingual	bilingue	ثنائي اللغة
ambisyllabic	ambisylabique	بين مقطعين
ambivalent word	mot avec deux sens contraires (ex :hote=guest/host)	لفظ من الأضداد  (دال على معنين متباينين كالجون للأسود والأبيض)
ameloration	amélioration  (connotive d’un mot)	ارتقاء دلالة الكلمة
ameliorative suffix	sufix d’amélioration connotive	زائدة ارتقائية
amnesic aphasia	aphasie amnésique	حبسة أمهية
amorphous change	changement irregulier	تحول غير قياسي
amorphous language	langue amorphe	لغة عازلة
amplificative	amplification ;accumulation	تكبيري(عكس تصغيري )
amplitude	amplitude	سعة الصوت
amusia	musie	عمه الألحان
anaculuthon	anacoluthe	التفات(صورة بيانية)
analogical change	changement analogique	تحول حملي
analogical extention	extension analogique	توسع قياسي
analogism	analogisme	القياسية
analogue	analogue	نظير
analogy	analogie	قياس (تناسب،شبه)
analphabetic notation	symboles diacritiques/phonétiques	علامة الاعجام
analytical (analytuc) language	langue analytique	لغة إلحاقية
anaphora	anaphore	إحالة العائد(في التراكيب)  تصدير( في البلاغة)
anaphoric reference	renvoi anaphorique	إحالة العائد
anaphoric subtitude	substitut anaphorique	العائد
anaphoric word	mot anaphorique	1-العائد 2-لفظة التصدير
anaptytic vowel	anaptyctique (phoét.) ;épenthétique	صوت مقحم
anaptyxis	anaptyxix ;épenthése	إقحام المصوت
anarthia	anarthie ;aphasie d’expression	حكلة ،رتة
anastrophe	anastrophe	تقديم وتاخير  (في كلمات الجملة)
ancestor language	langue souche/mére	اللغة الأصلية
angle of jaws	angle maxilaire	زاوية فكين
animal language	langage animal	لغة الحيوان
animate (noun)	animé	اسم الحي(عكس جماد)
annective composition	composition annective	تركيب إضافي
annexiation	annexion	إضافة
annomination	jeu de mots	تورية فكهة
anomalism	anomalisme	الشذوذية   (في قواعد اللغة)
anamalous	anomal	الشاذ
anomolous verbs	verbes anomaux ;verbes irreguliers	أفعال شادة(لا تلتقي على أصل واحد)
anomaly	anomalie	شذوذ
antanaclasis	antanaclase	ترديد(والاستخدام نوع منه)
antecedent	antécédent	المعود إليه
antepenultimate	antépénultième	سابق لما قبل الآخر
anterior	antérieur	أمامي (من مقدم الفم)
anthroponymy	anthroponymie ;anomastique ; anticadence	دراسة أعلام الأشخاص
anticipation	anticipation	توقع (في التقريب)
anticipatory	anticipant ;regressif	توقعي
anticipatory axpansion	expansion assimilatoire ;assimilation regressive	تقريب توقعي
antigrammatical construction	construction  agrammatical	تركيب لا نحوي (غير مستقيم أو ملحون)
anti -mentalism	antimentalisme	اللاذهنية
antirhythmical	anticadence	رتابة (تواتر النغمة)
antithesis	antithése	طباق
antonomasia (appellative)	utilisation d’un adj.comme nom propre	تغليب
antonym	antonyme	مضاد
antonymy	antonymie	تضاد( في الدلالة)
aorist	aoriste	متعدد الأزمنة
aperture	aperture	اتساع المخرج
apex	apex	طرف اللسان ،الذولق
apharesis ;aphersis	aphérése	سقوط الأول
aphasia	aphasie	حبسة
aphoristic	aphoristique	قول مأثور
aphrasia	paraphrasie	عطسلطة
apical articulation	articulation apical	
apico-alveolar	apico-alvéolaire	ذولقي (أسلي المخرج)
apico-dental	apico-dental	ذولقي نطعي
apico-lateral	apico-latéral	ذولقي أسناني
apocopation	apocope	ذولقي منحرف
apocope	apocope	جزم
apocope	apocope	بتر
apodosis	apodosz	جواب الشرط
apophony	apophonie ;alterence	تحول بالتعاقب
aposiopesis	aposiopése	التفات مقطوع
aposteriori languge	genre de langue artificielle basée sur des langues naturelles	لغة اصطناعية مركبة
apostrophe	apostrophe	1-وصلة (علامة حذف) 2-مناداة
appellation	appellation	تسمية
appellative function	fonction appellative	وظيفة الاستفتاح
appellative name	appellatif	اسم جنس
application	application	تطبيق (المدلول عليه)
applied linguistics	linguistique apliquée	اللسانيات التطبيقية
apposition	apposition	بدل،عطف بيان
appositive clause	relative appositive	جملة بدل
approximat	son continu non-fractif	بيني
apriori language	langue artificielle (non basé e sur les langues naturelles)	لغة اصطناعية(غير مبنية على لغات طبيعية)
arbitrariness	arbitaire	اعتباطية
archaïc	archaïque	مهجور
archaïsm	archaïsme	لفظ مهجور
archiphoneme	archiphonéme	وحدة صوتية جامعة
archistrataum	archistrataum	لغة خاصة
area language	langue régionale	لغة إقليمية
area linguistics	géographie linguistique	جغرافية اللغة
argot ;cant	argot	لهجة خاصة  (بطبقة اجتماعية أو مهنة معينة)
article(s)	article(s)	أدوات التعريف والتنكير  (في بعض اللغات الأروبية)
articulate language	langage articulé	كلام مقطع
articulation	articulation	نطق ،تلفظ
articulator	articulateur	عضو النطق
articulatory movement	mouvement articulatoire	حركة إخراج الحرف
articulatory parameter	paramètre articulatoire	متغير نطقي
articulatory phonetics	phonétique articulatoire	صوتيات فزيولوجية (في مقابل صوتيات التموج)
articulatory system	système articulatoire	جهاز النطق
artificial language	langue artificielle	لغة اصطناعية
artificial script	écriture artificielle	كتابة اصطناعية
artificial speech	synthèse de la parole	كلام مصطنع (التركيب الاصطناعي للكلمات)
aryténoïde	aryténoïde	الطهرجهاليان،الهرميان
ascending diphthong	diphtongue ascendante	صوت مركب صاعد
asemantic	asémantique	محال
aspect	aspect	كيفية الحدث أحوال الحدث
aspirate	aspiré	انفجار نفسي(الصوت)
aspirated stop	occlusive aspirée	مصوت نفسي
aspiration	aspiration	نفس
assertive	assertif	خبري(في مقابل الاستفهام والأمر والطلب عامة)
assibilant ;assiblate	assibilant ;assibilé	مصفر
assibilation	assibilation	تصفير (للحرف الشديد وغيره)
assimilation	assimilation	تصفير الصوت تقريب صوتي مشاكلة
assimilatory phonem	phonème assimilateur	المقرب إليه
association group	association de mots	مجموعة متداعية المعنى
associative etymology	étymologie populaire	تغيير بالتوهم  (استبدال كلمة بأخرى)
associative field	champ d’association	مجال التداعي
associative relations	rapports d’association	علاقات التداعي
assonance	assonance	جناس صوتي مجانس صوتي
asterisk	astérisque	نجمة (علامة للصيغ المفترضة أو غير المقبولة)
ésthenphania	asthénie phonique	نهك صوتي
asyllabique	assyllabique ;assyllabéme	لا مقطعي (فونيم)
asymmetry of organs	asymetrie des organes	عدم التوافق العضوي
asynndetic	construction ;asyndetent asyndéte	فصل (في مقابل الوصل)
asynataxic composition	composition asyntaxique	بناء لا تركيبي
athematic	athématique	لا أصلي  (لاصقة لا تكون أصلا)
atlas (linguistic)	atalas (linguistique)	أطلس (لغوي)
atonic	atone	لا منبور (بنبر رئيسي) غير منغم
attack	attaque	ابتداء الصوت
attested form	forme attestée	صيغة موثقة
attraction	attraction	جذب (تأثير عنصر لغوي على آخر)
attribute ;attributive	épithète (adj)	نعت،صفة
attributive construction	constriction adjectivale (servant comme épithéte)	تركيب،وصفي
attrition	attrition ;affaiblissement	إضعاف متدرج
audibility	audibilité	مسموعية
audi-muteness	audi-mutité	عمه لغوي
audiogram	audiogramme	مسامعية  (رسم السمع)
audio-lingual	audio-lingual	سمعي شفهي
audiology	audiologie	السمعيات(علم السمع)
audiomter	audiométre	مسماع
audiometry	audiométrie	قياس السمع
audio-visual	audio-visuel	سمعي بصري
auditory area/centre	centre auditif	مركز السمع
auditory discrimination	Discrnement auditif	تمييز سمعي
auditimory feedbback	auditif;rétrocation auditive	ترجيع سمعي (سماع المرء نفسه)
audiotory language	langage auditif	كلام مسموع
auditory phonetics	الصوتيات السمعية	الصوتيات السمعية
augmemt	augment	سابقة مصوتية (زيادة)
augmentation	augmentation	تعظيم (عكس تصغير)
augmentative.	augmentatif	مكبر
aural discrimination	discernement auditif	تمييز سمعي
Aural_oral	audio-aural	سمعي شفهي
automatic alternation	alternance automatique	تعاقب اضطراري
automatic translation	Traduction automatique	ترجمة آلية
automatic variant	Variante conditionnée; alternant conditionné	بدل اضطراري
atonomous sound	son autonome	مستقل  كياني الصوت
autonomous sound-change	changement phonétique autonome	تحول صوتي مستقل
autonomous syntagm	syntgame autonome	1-تركيب مستقل 2-مركب مستقل (وحدة النظم المستقل)
autonomous word	mot autonome	كلمة مستقلة
authority	autorité	حجة
auxiliary	auxiliaire	أداة  مساعد
auxilary language (as a mean of communication between different communities)	lingua franca	–لغة اصطناعية  2-لغة مشتركة
auxiliary sign/mark	symbole  diacritique	علامة مساعد علامة إعجام (فيما يخص الكتابة)
auxilary verb	verbe auxiliaire	1-أداة فعلية  2-فعل مساعد
axiomate	axiomatiser	صياغة إلى أصول وفروع
axiomatic	axiomatique	نظرية تفريعية
		
		
		
		
		
		
		
		
		
		
		
		
		
		
		
		
		
		
		
		
babbing	babillement ;babil	هلهلة  بأبأة( في مراحل اكتساب اللغة )
baby- talk	babil enfantin	هلهلة ،بأبأة
back-formation	dérivation régressive	اشتقاق بالحذف
back-soud	son d’arrière	مستعل
back vowel	voyelle d’arriéré voyelle postérieure	مصوت مستعل
barbarisme	barbarisme	عجمة خطأ لغوي (في مقابل الخطأ النحوي)  لحن(عامة في الاصطلاح الأنجليزي)
bare	nu	مجرد
base component	base syntagmatique	عنصر تركيب أصلي
base component	composé primaire ;composé de base	مركب أصلي
base form	forme basique	صيغة أصلية
base rules	régles catégorielles/syntagmatiques	قواعد تركيبية أصلية
basic alternant	alternant de base ;forme basique	أصل البدل
basic language	langue de base	لغة أصلية لغة أساسية
basic sentence	phrase type/sous-jacente ; phrase noyau	جملة اصلية
basic vovabulary	vocabulaire de base	مفردات أساسية
basic of articulation	base articulatoire	مخرج أصلي
basic of derivation	base de dériviation	المشتق منه
behaviourism	behaviourisme	السلوكية
bidirectional	bi-directionnel	مزدوج الاتجاه
bilabial	bilabial	من الشفتين (صوت شفوي يلفظ بواسطة الشفتين )
bilabiodentale	bilabiodentale	من الشفتين والثنايا
bilateral	bilateral	من الحافتين (حافتي اللسان) جانبي (من جانبي الفم)
bilateral consonant	consonne bilatérale	صوت جانبي
bilateral opposition	opposition bilatérale	تقابل ثنائي
bilingual	bilingue	ثنائي اللغة
bilingual dictionary	dictionnaire bilingue	معجم ثنائي اللغة
bilingualism	bilinguisme	ازدواجية اللغة
biliteral	billitteral billitéral ;bilitére	ثنائي الحروف (في المقابل الثلاثي والرباعي وغيرهما)
bianarism ;binarity	binarisme	الثنائية
binary construction	construction binaire	تركيب ثنائي
binary cut	segmentation binaire  ; coupe-binaire	تقطيع ثنائي
binary priciple	principe de binarisme	مبدأ الثنائية
biolingyuistics	biolinguistique	اللسانيات الاحيائية
bipartite system	système bipartite	نظام ثنائي المقسم
bisemy	bisémie	ثنائي الدلالة
biunique ;biunivoque	biunivoque	متناظر(طردي-عكسي)
blade of the tongue	lame	طرف اللسان (ويسمى ذولقا و أسلة أيضا)
blade sound	préplato-spécial	نطعي ذولقي
blocked transformation	transformation bloquée	تحويل ممتنع
blocked syllable	syllable fermée	مقطع ساكن
blocked vowel	voyelle entravée	مصوت ساكن ما بعده
body language	langage gestuel	لغة الإيماء
border mark ;boundary marker	marue de frontiére	علامة الطرف (التنوين مثلا)
borrowed word	emprunt	دخيل
bound accent/stress	accent lié/conditionné	نبر مقيد (ملازم أو اضطراري)
bound form	forme dépendante	صيغة مقيدة
bond morpheme	morphème dépendant ; morphème lié	حرف ملازم
bound noun	nom comptable	اسم معدود (قابل للجمع)
bound sentence	phrase subordonnée	جملة ملازمة  (جملة محمولة)
boustrophedon	boustrophédon	محراثية (كتابة)
bow-wow theory	oua-oua	نظرية البوهرة (نظرية في نشأة اللغة)
brachylogy	abrégement	حذف معلوم
bracketing	étiquettage	تقويس (لتجزئة الجملة)
branching	branchement	تفريع (في النحو التحويلي)
branching programme	multi-branche programme	برنامج متعدد الفروع
break in speech	pause	وقف
breath group	groupe (unité expiratoire)	مجموعة نفسية
breath pressure	pression d’éxpiration	قوة النفس (ضغط الهواء الداخلي)
breath state	état  de la glotte	حالة تنفس (حالة من أحوال المزمار أي من فوهة الحنجرة)
breath stream	colonne d’air	مجرى النفس
breve	signe diacritique indiquant la brévité ;signe de vrévité	علامة القصر (تكتب فوق المصوت للدلاله على قصره أو الضعف النبر إلخ)
bright vowel	voyelle claire	مصوت أمامي (مصوت مستقل أو منخفض)
broad transcription	transcription large	كتابة صوتية عريضة (فونيمية)
broad vowel	voyelle d’arriére	مصوت مستعل
broken plural	pluriel brisé	جمع التكسير
buccal	buccal	فموي
buccal cavity	cavité	تجويف الفم
buccal sounds	son oraux	أصوات من الفم
burring	grasse	لثغة الراء
brust	explosion	انفجار(إطلاق)
		
		
		
		
		
		
		
		
		
		
		
		
		
		
cacography	cacographie	1- خط غير واضح 2- هجئة خطية
cacology	cacologie	هجنة
cacuminal	cacuminal	تقعيسي
cadence	cadence	نغمة ختامية
caducous	caduc	معرض للحذف
caesura	césure	مقطع شعري
calligraphy	calligraphie	فن الخط
calque	calque	اقتراض بالترجمة
cononical form	forme canonique	صيغة معيارية (في الأصوات والصرف)
capacity	capacité	قدرة
cardinal nember	nombre cardinal	عدد أصلي
cardinal vowels	voyelles cardinales	أصوات المصوتات
caret	chevron	علامة إقحام يشكل()
case grammar	grammaire des cas	الحالات النحوية(مدرسة)
caste	traits distinctifs d’une classe	فصل (الجنس ثم النوع ثم الفصل)
casual speech	style informel ;style familier	أسلوب مبتدل
catachesis	catachesis ;catachrése	مجاز شائع
catalexis	catalexe	زحاف  (حذف عروضي)
catastase	catastase	مرحلة الحبس (تهيؤ العضو للنطق بالحروف)
catch	coup de glotte	همزة
categorial component	composante catégorielle	عنصر فصلي عنصر تفريعي
categorial grammar	grammaire catégorielle ;grammaire syntagmatique	نحو الفصائل
categorization	catégorisation	تقسيم (إلى فصائل)
category	catégorie	صنف قبيل
category symbol	catégorie symbole	علامة الفصلية
catenation	caténation ;concaténation	وصل اتصال(في مقابل البناء)
contenative verb	verbe copulatif	فعل رابط(في بعض اللغات)
cathodic oscillograph	oscillographe cathodique	مهزاز مهبطي
causal clause	proposition causale	جملة سببية
causal conjonction	conjonction causale	أداة تعليل
causative form	forme causative	صيغة التعدية
causative verb	verbe causatif	فعل التعدية
cavities (cavities of speech organs)	cavités	تجاويف (الأعضاء النطق)
cavity features	traits de cavité	صفات تجويفية
cavity friction	friction de cavité	احتكاك جوفي تسريب جوفي
cedilla	cédille	سديلة(علامة توضح تحت الحرف لتحديد صلته الصوتية
cenematics ;centics	cénématique	السينميات
ceneme	cénéme	سينم(وحدة صوتية في الكلوسيماتيك)
centering ;centralization	centralisation	توسط انتصاب في مقابل الاستعلاء والاستفال)
cental vowel	voyelle centrale	مصوت منتصب (من وسط اللسان)
centre	centre	وسط
centre of Broca	centre de Broca	مركز بروكا
centre of Wernicke	centre of Wernicke	
centrifugal	centrifuge	نابذ
centring diphthong	diphtongue centro-complexe	مصوت مركب وسطي
centripetal	centripéte	جابذ
centum language	langue « centum »	لغات كنتية (لم تتحول فيها الكاف إلى السين مثل اللغات الجرمانية)
cerebral	cérébral	متقعس(اللسان)
chain and choice	chainge et choix	تسلسل واختيار
change	changement ;évolution	تحول
channel	canal ;chenal	قناة (التواصل)
character	caractére	محرف  (حرف مطبعي)
characteristic feature	trait caractéristique	دراسة مميزات الكلام
characterology of speech	caractérologie de la parole	دراسة مميزات الكلام
cheked position	position fermée	موقع ساكن  (في الصوتيات)
cheked syllable	syllabe fermée	مقطع ساكن
checked versus unchecked	fermé/ouvert	مسدود/مفتوح (ساكن-متحرك)
checked vowel	voyelle fermée ;voyelle entravée	مصوت ساكن ما بعده
chest pulse	pulsation thoracique	دفعة صدرية
chiasme	chiasme	عكس(في البلاغة)
Chomsky adjoint	Chomsky adjointe	ملحق "تشومسكي"
chromatic accent	ton	نغمة نبرة (كما في الصينية والفيتنامية)
chrone	durée (voyelle)	مد
chroneme	chronéme	مدة(وحدة لقياس المد) كرونيم (ظاهرة الطول المميزة في المصوتات عادة)
class cleavage word	mot à double emploi	لفظ مشترك الجنس
classical language	langue classique	لغة كلاسيكية
classification of languages	classification des langues	تصنيف اللغات
class meaning	sens(signification) d’une classe	معنى الصنف
class noun	unité nominal	صنف الأسماء جنس الأسماء
class sign	marque de classe ;indice de classe	علامة الصنف
calss word(s)	indice de classe	صنف لغوي
clause	proposition	جملة
clause marquer	marqueur de proposition ;marqueur de fonction	دليل حكم الكلام  (وجود "هل" كدليل على الاستفهام)
clause pattern	proposition modéle	مثال الجملة
clause terminal	terminale  (de proposition)	وقفة
clausula	clausule	فاصلة
clear lateral ;clear « L »	latérale claire	منحرف مرفق
cleaving	clivage	فسخ
cliche (stock phrase)	cliché	عبارة جامدة  (تجري مجرى المثل)
click	clic ;click	نبصة
clipped proununciation	prononciation hachée/saccadée	كلام متقطع
clipped word	mot abrégé	كلمة مختزلة
clipping	abréviation	اختزال
closed class words	mots-outils ;mot fonctionnels	الألفاظ المحصورة العدد(وهي الأدوات أي حروف المعاني)
closed list	système clos	قائمة محصورة
closed repertory	répertoire clos	رصيد محصور
closed set/system	systéme clos	نظام محصور
closed state	fermeture( de la glotte)	حالة انغلاق (لفوهة الحنجرة)
closed syllable	syllabe fermée	مقطع ساكن
close vowel	voyelle fermée	مصوت ساكن ما بعده
closure	fermeture	إغلاق (اتباع بصامت ساكن أو تضييق المخرج)
closure	groupe d’éléments (linguistiques)	نسق
coalescence	coalescence	مزج صوتي
coalescencent assimilation	assimilation réciproque	تماثل متبادل
co-articulated	co-articulé	مزدوج المخرج
co-articulation	co-articulation	ازدواج المخرج
coda	fin de syllabe	نهاية المقطع
code	code	نظام رمزي (مواضعة أو وضع)
codification	codification(d’une langue)	تدوين اللغة
cognate language	langue parente ;langue apparentée	لغة لنفس الأصل
cognates	formes correspondantes ;concordances de vocabulaires	نظائر تاريخية
cognate word	mot correspondant ;concordances de vocabulaires	النظير (من حيث القرابة التاريخية) نظير تأصيلي
cognitive meaning	sens cognitif	معنى وضعي (ما وضع له في اللغة بالأصل)
cognitive reality	réalité cognitive	الواقع المعقول
cohesion	cohésion	ترابط (شدة الاتصال وعدمها عند النحاة العرب)
cohortative mood	forme cohortative	صيغة التحضيض
cohyponyme	cohyponyme	متجانس المعنى
coinage	invention (d’un mot)	توليد كلمة
coined word	mot inventé ;néologisme	كلمة مولدة
collation	collation	تجميع
collective noun	nom collectif	اسم جمع
colligation ;collocation	collocation	مصاحبة لفظية
collision	collision	اصطدام
collocation accent	accent de collocation	النبرة المصاحبة اللفظية
colloquialism	forme (expression) parlée/familiére	التعبير العامي
colloquial speech	langage familier ;langue parlée	العامية(الدارجة) لغة التخاطب(وقد لا تكون عامية)
colouring	coloration (d’un son)	اصطباغ للمجاورة  تأثير جرس المصوتات )
combination	combinaison	تركيب
combinative change (combinative sound change)	changement phonétique combinatoire	تحول صوتي تركيبي (أو مسبب لأنه ناتج عن التركيب)
combinatorial semantics	sémantique combinatoire	علم المعاني التركيبي
combinatory change	changement combinatoire	تحول صوتي تركيبي
combinatory variant	variante combinatoire	بدل تركيبي (وهو مسبب وواجب لأنه ناتج عن التركيب)
comitative	comitatif	حالة المعية  (أي في مدرسة الحالة الإعرابية في النحو)
command	ordre (impératif)	أمر
comment	commentaire	خبر جملة  (في النحو) مسند (في مقابل المسند إليه)
common case	forme non-fléchie	حالة إعرابية مشتركة  (غير متصرفة)
common core	vocabulaire commun ;vocabulaire de base	مفردات مشتركة
common gendere	genre des épicènes	جنس مشترك
common language	langue commune	لغة مشتركة
common mood	nom commun	صيغة ثبوث
common noun	nom commun	اسم الجنس (في مقابل العلم والضمائر و أسماء الإشارة وغيرها)
common speech	langue commune	كلام مشترك
communication	communication	اتصال تبليغ
communication funtion	fonction communicative	وظيفة التبليغ
communication	communication	تبديل تعاقب
compact phoneme	compact phonème	وحدة صوتية  متجمعة
comparative degree	degré de comparaison	درجة تفضيل
comparative grammar	grammaire comparée	النحو المقارن
comparative linguistics	linguistique comparée	اللسانيات المقارنة
comparativism	comparativisme	مذهب النحو المقارن
comptability	comptabilité	تساوق
compensatory lengthening	allongement compensatoire	مد تعويضي
compensatory shortening	raccourcissement compensatoire	قصر تعويضي
competence	compétence	الملكة اللغوية
complement	complément	خبر (خبر كان والمفعول به مثلا)
complementarity	complémentarité	تكامل دلالي
complementary distribution	distribution complémentaire	تعاقب بالتنافي
complementation	complétivisation	حمل جملة (على أخرى)
comlementizer	complétiviseur	المحمول به ( مثل أن وأنّ) تقريب تام
complete assimilation	assimilation complète	تماثل (في مقابل التجانس وهو التقريب الجزئي)
complete interrogation	assimilation complète	استفهام تصديقي
complete verb	verbe intransitif verbe non-féfectif	فعل لازم فعل تام (غير ناقص)
completive sentence/fragement	fragement completiif	جملة محمولة (لها موضع من الإعراب)
complex peak	sommet complexe	قمة مركبة نواة مركبة
complex sentence	phrase complexe	جملة مركبة
complex stop	occlusive complexe	ساكن مركب (حرف شديد مركب)
complex vowel	voyelle complexe	مصوت مركب
compound tense	temps composé	صيغة الفعل المركبة
compromise language	koiné	لغة مشتركة
pomutational linguistics	linguistique de calcul	اللسانيات الرتابية (الرياضية)
computer science	informatique	المعلوميات
conative	conatif	صيغة التكلف وظيفة الأمر والنهي
concatenation	concatenation	سلسلة (وصل العناصر وضده البناء فب نظرية الخليل وأتباعه)
concept	concept	تصور مفهوم
conceptual theory of meaning	théorie conceptuelle du sens	النظرية التصورية للمعاني
concessive	concessive (proposition)	جملة استدراكية
concomitance	concomitance	تلازم الصفات
concord	accord	توافق
concordance	concordance	مطابقة
concrete noun	nom concret	اسم عين (في مقابل اسم معنى)
concrete sound	son concret	صوت محصل
conditionnal	conditionnel	شرطي
conditionnal clause	proposition conditionnelle	جملة شرطية
conditionnal perfect tense	temps conditionnel composé	صيغة الشرط الماضية (في اللغة الأنجلزية)
conditionnal sound change	changement phonétique conditionné	تحول صوتي مسبب
conditioned variant	variante conditionnée	بدل تركيب  (وهو مسبب وواجب لأنه ناتج عن التركيب)
configuration	configuration	هيئة
confitmatory interrogative	interrogation corroborative	استفهام تثبيثي
congruence	conformité ;congruence	توافق (البنية او الصيغة)
conjugaison	conjugaison	تصريف الأفعال
conjonction (form)	conjonction	الوصل
conjonctions	conjonctions	أدوات الوصل
conjunctive adverb	locution conjonctive	قرينة الوصل
conjuctive definition	définition conjonctive	حد الوصل
conjunctive pronoun	pronom atone	ضمير متصل
connecting consonant/vowel	phonéme /morphéme de transition phonéme/morphéme connecteur	صامت رابط مصوت رابط
connective	conjonction ;locution conjonctive ;connectif	أداة وصل أداة ربط
connective construction	construction connective	تركيب برابطة
connector	connecteur	رابط (في الجملة)
connivence	connivence	تظاهر
connotation	connotation	دلالة المعنى (في مقابل المعنى الأصلي أو المعنى الوضعي)
connontative meaning	sens conntatif	دلالة المعنى
consecutive interpreting	traduction consécutive	ترجمة تتبعية
consequence clause	subordonnée de conséquence	جواب شرط
consonance	consonance	تجانس صوتي
consonnant	consonne	صامت جامد
consonantal	consonantique	خاص بالصوامت
consonant cluster	groupe consonantique	نسق من الصوامت
constant oppositions	oppositions constantes	متقابلات ثابتة
constituent	constituant	مكون
constituent class	mots de même classe	مكونات متشابهة في الوظيفة
constituent grammar	grammaire de constituants	نحو تقسيمي  (يحصل فيه التحليل بالقسمة)
constriction	constriction	إرخاء تسريب
constrictive	constrictive	احتكاكي(صوت) رخو أو تسريبي (حرف)
construct	construit	تركيب تمثيل
constructed language	langue artificielle	لغة مصنوعة
constriction	constriction	تركيب
contact	contact(des langues)	اتصال اللغات  (تفاعل اللغات وتداخلها)
contact vernacular	sabir	لغة اتصال
contagion	contamination	تداخل (الحمل على النظير)
contamination	contamination	الحمل على الموضع
content	contenu	محتوى مضمون
content elements	éléments du contenu	عناصر المحتوى
content (full) word	morphème lexical	كلمة معجمية لفظة تامة
context	contexte	سياق قرينة
context free	indépendant du contexte	خارج عن السياق
context of situation	contexte de situation ;contexte situationnel	قرينة حالية (في مقابل القرينة المقالية) مقتضى الحال
context restricted/sensitive	dépendant de contexte	مقيد بالسياق
contextual analysis	analyse contextuelle	تحليل سياقي
contextual meaning	sens contextuel	معنى سياقي
context variant	variante contextuelle	بدل سياقي
contigous assimilation	assimilation de contiguité	تقريب بالجوار
contigous dissimilation	dissimilation de contiguité	تبعيد بالجوار
continuant	consonne continue ;consonne « durative »	صامت ممتدّ (في مقابل المنقطع) صامت زماني (في مقابل الآني)
continuant (versus non continuant)	continu(vs.non continu)	ممتد (في مقابل غير الممتدّ)
continous aspect	aspect continu ;aspect inaccompli ;aspect progressif	حدث متصل
continous constituents	constituants non-discontinus	مكونات متتابعة
contoid	conoïd	صامت
contour	contour	منحنى التنغيم
contraction	contraction ; coalescence	إدماج ومنه الإدغام
contrast	contraste	تباين تفاضل
constrasctive analysis	analyse contrastive	تحليل تبايني
constrasctive function	fonction contrastive	وظيفة تباينية
constrasctive grammar	contrastive grammaire	النحو التفاضلي
constrasctive linguistics	linguistique constractive	اللسانيات التفاضلية
constrasctive opposition	opposition constractive	متقابلات التباين
conventional	conventionnel	وضعي اصطلاحي
convergence	convergence	تلاق (في اللغات  أو اللهجات)
convergence area	aire de convergence	منطقة التلاقي
conversational style	style conversationnel	أسلوب التخاطب العادي
conversion	conversion	نقل من جنس إلى آخر
co-occurence	co-occurence	تواقع
co-ordinate clause	proposition coordonnée	جملة معطوفة
co-ordinate construction	construction cooedonnée	تركيب معطوف
co-ordinate endocentric construction	construction endencentrique coordonnée	تركيب مشتمل على نظير معطوف
co-ordinating conjunction	conjonction de coordination	أداة العطف
coordination	coordination	عطف النسق
coordinator	coordonnant	حرف العطف
copula	copule	فعل رابط (مثل فعل الكينونة)
coranic orthoepic	orthoépie coranique	علم القراءات (القرآنية)
core	base/noyau	جوهر المقطع نواة
co-reference	co-réference	وحدة الإحالة
coronal	coronal ;liminal	نطعي ذولقي
corpus	corpus	عينة البحث (اللغوي) مدونة
correctness	correction	سلامة
correlation	corrélation	تناظر
corrélative consonants	consonnes coorélatives	صوامت  متناظرة
correlative words	mots corrélatifs	كلمات الربط المتناظرة
corespendence	correspondance	توافق تطابق
corrupt pronunciation	prononciation corrompue	نطق فاسد
cost of information	cout de l’infirmation	كلفة الإفادة
count noun	nom comptable	اسم معدود (قابل للافراد والجمع)
co-varriance	co-varriance	تغيير متناظر
creativity	créativité	إبداعية
creole	créole	كريول (لغة خاصة)
creolized language	langue créolisée	لغة مولدة
crest of sonority	sommet de sonorité	قمة الجهارة
cricoid	cricoïde	غضروف حلقي
crossing	croissement	تداخل الكلام
cryptanalysis	cryptanalyse	تحليل المعنى
culminative function	fonction culminative	وظيفة الابراز (بالنبر) (بيان الموقع الأهم في الكلمة أو مجموعة من الكلمات بالنبر)
culminative opposition	opposition culminative	متقابلات الحصر
cultural language	langue de culture	لغة الثقافة
cultural transmission	transmission culturelle	نقل ثقافي  (من جيل إلى جيل)
cumul	affixe multisémique affixe a multifonction	زائدة متعددة المدلولات
cumulative cruve	courbe cumulative	منحى التراكم (في علم الأسلوب وعلم اللسان الكمي)
cuneiform script	cuneiforme	خط مسماري
cursive writing	écriture cursive	كتابة يدوية
cybernetics	cybernétique	علم الضبط الآلي (دراسة لغة الاتصال والتحكم بين الإنسان والآلة او بين الآلة والآلة)
cycle	cycle	دورة
cyrillic alphabet	alphabet cyrilique	ألفبائية سيريلية
		
		
		
		
		
		
		
		
		
		
		
		
		
		
		
		
		
		
		
		
		
		
		
		
		
		
		
		
		
		
		
		
		
		
		
		
damped filter	filtre amorti	مرشح مضمحل
damping	assourdissement  (d’un son)	تخفيض (سعة التموج) إخفات
damping curve	courbe d’assourdissement	منحنى الاضمحلال
dark lateral	latérale vélarisée ; latérale dure	صوت منحرف مفخم
dark vowel	voyelle sombre	صوت مفخم
darmesteter’s law	loi de darmaesteter	قانون "دار مستتر"
dative	datif	حالة التخصيص بالإضافة  (مثل المفعول غير المباشر)
dead language	langue morte	لغة ميتة
deaf -muteness	surdi-mutité	بكم الصمم
de-aspirited	désaspiré	مزال عنه النفخ
deceptive	faux correspendant	نظير وهمي
decibel	decibel	دسبل (وحدة وضوح وقع الصوت)
declamatory style	style déclamatoire	أسلوب خطابي
declarative mood	declaratif	صيغة الثبوت (الفعل) خبر (في مقابل الإنشاء) حكم من أحكام الكلام
declension	declination	إعراب الأسماء
decoding	décodage	فك الرموز  (توضيع في الخطاب)
decremental curve	courbe dectré-mentale	منحنى التناقض (في علم الأسلوب الأحصائي وعلم اللغة الكمي)
de-dialectralization	dédialctralisation	إزالة الاختلاف اللهجي
deep grammar	grammaire profonde	نحو عميق نحو تقديري
deep order	ordre profond	رتبة عميقة
deep strecture	strecture profonde	بنية عميقة
deep vowel	voyelle postérieur	مصوت مستعل
de-etymologization	déétmologisation	تأثيل  عكسي
defect	défaut	خلل  (في الكلام)
defective verb	verbe defectif	فعل ناقص
edefence	defen	النهي
deferred preposition	préposition en fin de phrase	حرف جر مؤخر
definite article	article défini	ال التعريف
definite determiner	determinant défini	أداة التعريف
deflection (deflexion)	de-inflexion	إزالة التعريف
degeneration of meaning	dégénération sémantique	انحطاط المعنى
degrammaticalization	dégrammaticalisation	تلغية (تحول إلى كلمة مفردة)
deictic function	fonction deictique	وظيفة الإشارة
deictic word	mot deictique	اسم إشارة
deixis	deixis	حالة الإشارة
delabilization	délabilisation	إزالة الضم
deletion	effacement	حذف (في النحو التحويلي)
dzlibrate speech	parole soutenue	كلام جزل (ضده الركيك)
delimitation	délimitation	تحديد
delmiltative opposition	opposition délimitative	متقابلات التحديد
demarcation	démarcation	فصل موقعي
demarcative function	fonction démarcative	وظيفة تمييز الموقع
demarcative opposition	opposition démarcative	تقابل موقعي
demarkting (mark)	démarcatif	علامة فصل
demonstrative adjective	adjectif démonstratif	اسم إشارة متصل
demonstrative pronoun	pronom  démonstratif	اسم إشارة منفصل
demotic	démotique	ديموطيقي
denasalisalization	dénasalisation	إزالة الغنة
denominative	dénominatif	مشتق من الاسم
denotation	dénotation	المعنى الحقيقي
denotative meaning	sens dénotatif	معنى حقيقي
density of communication	intensité de la communication	كثافة الاتصال اللغوي
dental	dental	أسناني (خاص بالأسنان)
dentaolabial	dentilabilal	شفوي من الثنايا العليا
depalatalization	dépalatalisation	حذف التحنيك
depence	dépence	ارتباط (محمولية أو بناء الشيء على غيره)
dependency grammar	grammaire de dépence	نحو ارتباطي نحو حملي
dependant clause	proposition dépendante ;proposition subordonnée	جملة محمولة (غير مستقلة)
dependant sound change	changement phonétique conditionné	تحول صوتي تركيبي
dephonologization	déphonologisation	إحراف  (فقد الحرف صفاته الذاتية)
deplacement	déplacement	نقل قلب مكاني
deponent verb	verbe déponent	فعل متعدي المعنى
derivation	dérivation	اشتقاق توليد الجملة  قفي المدرسة التحويلية)
derivational affix	affixe derivationnel	زائدة اشتقاقية (أو للتفريغ)
derived primary word	mot primaire dérivé	كلمة مشتقة أولية
derived secondary word	mot secondaire  dérivé	كلمة مشتقة ثانوية
derived sentence	phrase dérivée	جملة مفرعة (من جملة أخرى)
descendant language	langue dérivée :langue fille	لغة متفرعة
descending (falling ) diphtong	diphtongue descendante /décroissante	مزدوج حادر
descriptive adequacy	adéquation déscriptive	استيفاء الوصف
descreptive definition	définition déscreptive	حد وصفي
descreptive grammar	grammaire déscreptive	النحو الوصفي
descreptive linguistics	linguistiqur déscreptive	اللسانيات الوصفية
descreptivism	descreptivisme	مذهب الوصفية المدرسة الوصفية
desiderative verb	verbe désidératif	فعل الرغبة
designation	sésignation	دلالة محسوسة  (على مسمى معين)
detente	détente ;métastase	إطلاق (في مقابل الحبس)
deterioration	péjoration	الذم
deteriorative suffix	suffixe de péjoration	زائدة للذم
dererminant ;determiner	détermination	مخصص عنصر تخصيص
determination	détermination	تخصيص (في مقابل الابهام)
		الجزء المخصص
devangari	dévangari (écriture)	دافنقارية (الكتابة المستعملة في بعض اللغات الهندية)
deverbative	déverbatif	مشتق من الفعل
deviance	déviance	شذوذ
deviant	déviant	شاذ
devoicing	dévoisement	إهماس
diachronic	diachronique	تاريخي زماني (في مثابل الآني)
diachronic change	changement diachronique	تحول زماني
diachronic grammar	grammaire historique	النحو التاريخي
diachronic linguistics	linguistique diachronique	اللسانيات التاريخية
diachrony	diachronie	النظرية التطورية
diacritic mark	signe diacritique	علامة إعجام
diaersesis ;diaresis (trema)	signe de l’umlaut  (trema)	علامة الإمالة  (الترقيق في اللغات الجرمانية) علامة النطق المنفصل
diagnostic environement	environnement diagnostique	قرينة معينة
dialect	dialecte	لهجة
dialectal  differenciation	différenciation dialectale	اختلاف اللهجات
dialectalization	dialectisation	تشعب اللغة إلى لهجات)
dialect variant	variante dialecte	بدل لهجي
dialect area	air dialectale	مساحة امتداد اللهجة
dialect atlas	atlas dialectal/lnguistique	أطلس اللهجات
dialect borrwing	emprunt dialectal	دخيل لهجي
dialect boundary	frontière (limite) dialectale	حدود اللهجة
dialect geography	géographie dialectale/linguistique	جغرافية اللهجات
dialectology	dialectologie	علم اللهجات
dialinguistique	dialinguistique	دراسة الازدواجية اللغوية
diaphone	diaphone	بدل لهجي دايافون (تنوعات نطق للفونيم)
diaphoneme	diaphonéme	وجوه أداء الحرف  (كوحدة صوتية)
diaphragm	diaphrgme	حجاب
dia-system	diasystéme	أنظومة (نظام مندمج)
diction	diction	جودة الأداء
dictionary	dictionnaire	قاموس
differential meaning	sens différentiel	معنى مميز (المشترك اللفظي)
diffrenciation	différenciation	مخالفة صوتية
differenciative opposition	opposition différenciative	تقابلات التمييز
diffuse	diffus	صوت منتشر (متفرق)
diffusion and migration theorie	théorie de diffusion et de migration	نظريتا الانتشار والنزوح
diglossia	diglossie	ثنائية لغوية
digraph	digraphe	تهجئة مزدوجة
dilation	dilation ;assimilation à distance	اتباع مماثلة متباعدة
diminutive	diminutif	صيغة تصغير
ding-dong theory	théorie onomatopeique du language (dig –dingue-dong)	نظرية المواضعة الأصلية
diphoneme	diaphone ;diaphonéme	نقلة
diphthong	diphtongue	مصوت مزدوج
diphthongization	diphthongaison	تحويل المصوت إلى مزدوج
diptote	diptote	غير منصرف (الممنوع من الصرف)
direct discourse	discours direct	حكاية (قول)
directive construction	construction exocentrique	تركيب غير مشتمل على نظير
directive particale	particule directionnelle	أداة للهجة
direct method	méthode directe	الطريقة المباشرة (في تعليم اللغات الأجنبية)
direct object	objet direct	مفعول به
director	élément directeur	عنصر أساسي
direct question	question directe	استفهام مباشر
dirct speech	style direct	حكاية(قول)
disambiguation	désambiguisation	إزالة اللبس
discountinuity	discontinuté	انقطاع
discontinous constituents	constituants  discontinus	مكونات منقطعة
discontinuous formant	formant discontinu	مكون منقطع
discontinuous  morpheme	morphème discontinu	دالة منقطعة
discourse analysis	analyse de discours	تحليل الخطاب تحليل الكلام
discovery procedure	procédure de découverte	طريقة استكشافية
discrete units	unités discrètes	وحدات مميزة
disjunction	disjonction	تخيير (ربط عبارتين بـ أو)
disjunctive interrogation	interrogation disjonctive	استفهام تخييري
disjunctive opposition	opposition disjonctive	تقابل التنافي
disjunctive prounoun	pronom disjonctive	ضمير منفصل
disjunctive sound	son disjonctif	صوت مقحم
dispersion (language)	dispersion linguistique	تشتت لغوي
displaced speech	référence a un réferent absent ; discours sur un référent absent	كلام عن الغائب
dissimilation	dissimilation	تبعيد صوتي (في مقابل التقريب) تخالف
dissimilatory phoneme	phonéme dissimilé	حرف مبعد فونيم تخالفي مؤدي إلى المخالفة)
dissonace	dissonace	تنافر الأصوات
distant assimilation	assimilation à distance ;métaphonie	مماثلة متباعدة  اتباع وانحناء  (إمالة إذ كانت خاصة بالفتحة)
distinctive	ditinctif	مميز
distinctive features	traits distinctifs	صفات مميزة
distinctive function	fonction distinctive	وظيفة  مميزة
distribution	distribution	استغراق (القرائن)
distributional analysis	analyse distributionnelle	تحليل استغراقي
distritionalism	distritionalisme	النظرية الاستغراقية أو القسمية
distributional law	loi de distribution	قانون استغراقي
disyllabic	dissyllabe	ثنائي المقطع (كلمة تتألف من مقطعين)
divergent change	changement (phonétique) divergent	تحول افتراقي
documentary language	langage documentaire	اصطلاح وثائقي (لغة تنظيم الوثائق)
domesticated word	emprunt intégré	دخيل موطن
dorsal	dorsal	من ظهر اللسان
dorso-alveolar	dorso-alvéolaire	نطعي من ظهر اللسان
dorso-palatal	dorso-palatal	شجري من ظهر اللسان
dorso-uvular	dorso-uvulaire	لهوي من ظهر اللسان
dorso-velar	dorso-vélaire	صفاقي من ظهر اللسان
dorsum	dos de la langue	ظهر اللسان
double articulation	double articulation	تقطيع مزدوج
double bar juncture	marque de l’intonation montante	علامة التنغيم الصاعد (في الأواخر)
double comparaison	comparaison a deux degrés	تفضيل بطرفين
double consonant	consonne double	صامت مضعف
double cross juncture	marque de l’intonation descendante	علامة التنغيم الحادر (في الأواخر)
double formanant	bi-formantique	مزدوج البانية
double négative	forme négative double	نفي مزدوج
doublet	doublet	رسيلة  (بدل أو غير بدل)
double vowel	voyelle double /longue	مصوت ممدود
doubling	gémination	تضعيف تشديد
drift	changement linguistique successifs	اتجاه (بالنسبة للتطور اللغوي) تحول
dual	duel	مثنى
dualist theory of meaning	théorie dualiste du sens	نظرية ثنائية (الدلالة)
duality of pattern	dualité de pattern	ثنائية النمط
dummy element	élément vide/abstrait	عنصر افتراضي
duration	durée ;quantité	المد(الصوت)
durative aspect	aspect duratif	صيغة الاستمرار
dynamic accent	accent dynamique	نبر حركي
dysarthria	dysarthrie	حكلة
dyslalia	duslalie	تعسر عضوي للكلام
dyslexia	dyslexie	تعسر القراءة
dysmelodia	dysmélodie	تعسر النغم
dysorthographia	dysorthographie	تعسر الاملاء
dysphonia	dysphonie	انقطاع الصوت
dysprosodia	dysprosodie	تعسر التطويح
		
		
		
		
		
		
		
		
		
		
		
		
		
		
		
		
echo word	onomatopée	مصاداة (كلمة محاكية للأصوات الطبيعية )
ecology	écologie du langage	دراسة بيئة اللغة
agressive	expiré	زفيري
ajective	éjectif ;glottalisé	منبور مهموز
electromygram	électromyogramme	معضالية
electromygraph	electromygraphe	معضال
element	élement	عنصر
elevation	amélioration	مدح تعظيم
eliciation	éliciation	استنطاق
elision	élision	ترخيم (حذف الآخر)
ellipsis	elipse	حذف إيجازي إضمار
elliptic construction	construction elliptique	تركيب محذوف منه
embedded sentence	phrase enchassée	جملة مضمنة تركيبا
embedding	enchassement	تضمين تركيبي للجملة
emotive accent	accent emotif	نبر انفعالي
emphasis	emphase	تفخيم في العربية  توكيد معنوي
emphatic articulation	articultion emphatique	نطق مفخم
emphatic prounoun	sons emphatique	ضمير منفصل
emphatics	sons emphatiques	أصوات مفخمة
emphatic word	mot emphatisé	كلمة مفخمة
empty word	mot-outil	كلمة وظيفية (أداة او حرف معنى)
enallage	énallage	تضمين
enclisis	enclise	انضواء وصل بالمتقدم
enclitic	enclitique ;enclinoméne	موصول بما قبله (صوت)
encoding	encodage	ترميز (تحويل إلى رموز)
ending	détente	إطلاق
ending suffix	désinence	علامة لاحقة (كعلامة الإعراب)
endocentric construction	construction endocentrique	تركيب مركزي (مشتمل على نظير)
endophasia	endophasie	كلام باطني كلام نفسي
engram	engramme	انطباعة
entropy	entropie	احتمال
entry	entrée (léxicale)	مدخل  (معجمي)
enumerative	énumératif	عدد توضيحي
enunciation	énonciation	فعل الكلام
enunciatory	énonciataire	المحدث أو المتحدث
environnement	environnement	سياق قرائن لفظية
environnemental conditioning	conditionent contextuel	تأثير السياق
epanalpsis	épanlpse	تشابه الأطراف
epenthesis	épenthése	تشابه الأطراف
epenthesis	épenthétique	إقحام الصوت
epenthetic	épenthétique	إقحامي
epexegesis	epexégése	عطف بيان
epicene	épicéne	محايد (في الجنس النحوي)
epiglottis	épiglotte	غلصمة
epigraphy	épigraphie	دراسة النقوش
epiphonema	epiphonéme	زيادة للتوضيح
episememe	épiséméme	دالة نحوية (أصغر وحدة نحوية ذات معنى)
epistemology	épistémologie	نظرية المعرفة
epithet	épithéte	نعت
eponym	éponyme	مسمى(من اسم شخص) منسوب إليه
equational sentence	phrase copulative	جملة تعادل (جملة اسمية خبرها اسمها أو شبه جملة) جملة كينونية (متضمنة لرابطة)
equational sentence	phrase capulative	فعل تعادلي فعل الكينونة
equilibrium of system	équilibre du system	اعتدال النظام قصد
equipollent	équipollent	متعادل
equivalence	équivalence	توافق (البناء)
equivalent sentences	phrases équivalente	جمل متكافئة نظائر الجمل
		
erasing	effacement	حذف
ergative	ergatif	حكم الفاعل المعنوي (حالة إعرابية في بعض اللغات)
error analysis	analyse des fautes	تحليل الأخطاء
esphageal cavity	cavité oesophagienne	تجويف مريئي صوت بلعومي
essive	essif	حكم الصفة الحادثة
ethnographic linguistics	linguistique éthnographie	اللسانيات  الأثنوغرافية
ethnolinguistics	éthnolinguistique	اللسانيات  الأنتولوجية
ethnophonemic transcription	transcription éthnophonétique	كتابة فونيمية  أنتولوجية
etic	étique	غير وظيفي
etymological  cognate	correspendant étymologique ;congénére  étymologique	نظير تأصيلي  مشتركات لفظية
etymological doublet	doublet étymologique	رسالة تاصيلية
etymlogy	étymologie	علم تاصيل الكلام
etymon	étymon	أصل الكلمة (الأصل التاريخي)
euphemism	euphémisme	تلطيف( للعبارة  أو للكلمة) كناية
euphony	euphonie	عذوبة الصوت رخامة الصوت
evaluation procedure	procédure d’évaluation	طريقة تقييمية
evolution	évolution	تطور
evolutionary linguistics	linguistique évolutive	اللسانيات التطورية
exception	éxcéption	شواذ
exceptive particle	particule axceptive	أداة استثناء
exceptive sentence	phrase exceptive	جملة استثنائية
exclamation	exclamation	تعجب
exclamation mark	point d’exclamation	علامة التعجب
exclusive (exhaustive) definition	définition exhaustive/exclusive	حد جامع مانع
exclusive first person (exclusive personal pronoun)	pronom personnel exclusif	صيغة المتكلم وحده
excrescent consonant	consonne épenthétique	صامت إقحامي
exhaltion ;expiration	exhalation ;expiration	زفير
exhautivity	exhaustivité	شمولية
existential sentence	phrase existentielle	جمل وجودية (دالة على الوجود إثباتا او نفيا)
exocentric  construction	construction  excentrique	تركيب غير مشتمل على نظير
exolinguistics	métalinguistique	دراسة الوضع الثنائي (دراسة اللغة الاصطلاحية) اللسانيات الانتروبولوجية
exophasia	exophasie	نطق مسموع
expansion	expansion	فضلة (كل ما يزاد على المسند والمسند إلي في مقابل العمدة) اتساع المعنى فرع (في النحو التوليدي)
experimental phonetics	phonétique expérimentale	الصوتيات التجريبية
expiratory accent	accent expiratoire	نبر زفيري
expiratory movement	mouvement expiratoire	حركة التصعد الزفير
explanatory	explicatif	تفسيري تعليلي
explanatory adequacy	adéquation explicatif	استيفاء التفسير
explétive	explétif	لغو حشو
explicative linguistics	linguistique explicative	اللسانيات التعليلية
explicatory diachronic linguistics	linguistique diachronique explicative	اللسانيات التطويرية التعليلية
explicit	explicite	ظاهر صريح
explosion	explosion	انفجار تحريك (في مقابل السكون)
expression	expression	تعبير
expressive	expressif	تعبيري (بليغ أو مثير،بلاغي)
expressive features	traits expressifs	صفات تعبيرية  (أو بلاغية)
expressive function	fonction expressive	وظيفية تعبيرية
expressive intonation	intonation expressive	نغمة معبرة
expressivity	expressivité	بلاغة،التعبيرية
extension	extention	اتساع في المعنى طرد الزيادة الذات في مقابل المفهوم
extensional meaning	sens étendu	معنى متوسع فيه
extengram	extensogramme	ممدادية
extensometer	extensomètre	ممداد
extensometery	extensometerie	قياس التمدد
external hiatus	hiatus externe	التقاء خارجي لمصوتين
extinct language	langue morte	لغة ميتة
extraction	extraction	استخراج
extra-lingual features	traits extra-linguistique	صفات غير لغوية
extra-nuclear	extra-nucléaire	خارج عن النواة
extrinsic meaning	sens extrinséque	معنى خارجي
eye dialect	imitation dialectale	صيغة مكتوبة للهجة
		
		
		
		
		
		
		
		
		
		
		
		
		
		
		
		
		
		
		
		
		
		
		
		
		
		
		
		
		
		
		
		
		
facte (indicative ) mood	mode indictif	صيغة الثبوت  (في مقابل صيغة الغاية أو الشرط وغيرهما)
facultative variant	alternant facultatif	بدل اختياري
fading	affaiblissement	ضعف
falling diphtong	diphtongue descendante	مزدوج حادر
falling -rising	descendant-croissant décroissant-croisant	حادر صاعد (بالنسبة للتنغيم الكلامي) متناقض متزايد
false cognate	faux congénére	نظير وهمي
false palate	palais artificiel	حنك صناعي
familiale style	style familial	أسلوب الخطاب المبتدل  (الاستئناسي أو الاسترسالي)
fomiliar forms	formes familieres	صيغ الألفة
family of languages	famille de langues	فصيلة لغوية
family terms	nom de parenté	أسماء القرابة
family tree theory	théorie de l’arbre généalogique	نظرية النسب اللغوي
faucalization	faucalisation ;resserement  du pharynx	تضييق وسط الحلق
faucal sounds	sons pharyngaux (étroits)	أصوات حلقية (بالمعنى العام)
favourite sentence	phrase type/favorite	جملة نموذجية
feature	trait	صفة
feminine	féminin	مؤنث
field linguistics	linguistique sur le terrain	اللسانيات الميدانية
field of discourse	champ du discours	مجال الكلام
field study	étude sur le terrain	دراسة ميدانية
figurative	figuratif ;figuré	مجاز
figurative language	langage figuré	أسلوب مجازي
figure of rhetoric	figure de rhétorique	تعبير بياني
figure of speech	figure d’expression	صورة بيانية
filler class	genre tagmétique	جنس موقعي (كل أفراد الجنس التي تقع في الموضع الواحد)
final oposition	position finale	موقع نهائي آخر الكلام
finite state grammar	grammaire d’état fini	نحو المراتب المتناهية النحو المتناهي
finite verb	forme conjuguée du verbe	فعل غير مصدري
first articulation	première articulation	التقطيع الأولي
first infinitive	infinitif sans marque (to)	الفعل كمصدر  بدون to (خاص بالانكليزية)
first language	langue premiére	لغة المنشأ
first person	premiére personne	صيغة المتكلم
first possessive	adjectifs possessifs	ضمائر الملكية
first sound shift	changement consonantique primaire	تحول صوتي أول
fixation	forme fossilisée ;fixation	أحفورة لغوية
fixed stress	accent fixe	نبر ثابت
fixed word order	ordre fixe des mots	نظام ثابت للكلمات
flap	son battant	صوت احادي الرعدة
flapped sound	son battu	قرعة
flat	bémolisé	مخفوض
flectional endings	désinences	علامات الإعراب
flectional language	langue flexionnelle	لغة تصريفية
flexion(flexion) ;inflexion	flexion	تصريف
floating element	élement explétif	لغو حشو (عنصر زائد غير مفيد)
fluctuating speling	orthographe variable	تهجئة متذبذبة
fluency	facilité (de parole)	فصاحة طلاقة اللسان
focal area	région (air) étudie	منطقة (تأثير لهجة على سواها)
focal word	mot focalisé	كلمة مصدرة (للتوكيد)
folk etymology	étymologie populaire	توهم (التأصيل العامي)
foreignism ;alienism	emprunt ;interférence	عبارة أعجمية عجمة
forlorn elements	forme non-déclinable ;élément invariable	غير منصرف
form	forme	صيغة
formal	formel	صوري
formal amalgam	amalgame formel	امتزاج صوري
formal grammar	grammaire formelle	نحو صوري نحو شكلي
formalization	formalisation	صياغة رياضية
formal regularity	régularité formelle	اطراد صوري
formal speech	style soutenu	كلام جزل
formant	formant	مكون (بالمعنى العام) بانية (في علم الأصوات الفزيائي)
form class	classe de mots	قبيل لغوي
formulaic language	language spécial	لغة خاصة
form word	mot outil ;mot fonctionnel	أداة معنى (حرف معنى)
fortis	forte (consonne) (levis)	قوي الاعتماد (أو الضغط) في مقابل
fossile	fossile linguistique	أحفورة لغوية
fossilized form	forme fossilisée	صيغة مجمدة
fourier analysis	analyse de fourier (onde sonore)	طريقة "فورية" في التحليل
free alternant/variant	variante libre	بدل اختياري
free form	forme libre	صيغة مستقلة
free morpheme	morphéme indépendant	دالة مستقلة
free (movable ) stress	accent mobile	نبر متنقل
free position	position libre	موقع غير مقيد
free sentence	phrase indépendante	جملة مستأنفة
free syllabe	syllabe ouverte	مقطع مفتوح
free translation	traduction libre	ترجمة بتصرف
free variation	variation libre	تبدل جائز تنوع أدائي  (في مقابل الوظيفي)
free vowel	voyelle non arrétée	مصوت نهائي (في المقطع) مصوت غير مقيد (غير متبوع بصامت ساكن) نظام الكلمات الحر
frequency	fréquence	تردد (في الأصوات) تواتر
frequency analysis	analyse de fréquence	تحليل التردد
frequency count	analyse de fréquence léxicale	إحصاء الشيوع تحليل إحصائي للمفردات
friction	friction	احتكاك (عند الغربيين) تسريب (عند ابن سينا) رخاوة (عند النحاة والقراء)
frictionless continuant	contoid continus non frictionnels	حروف زمانية غير رخوة صوامت متمادة غير احتكاكية
front mutation	inflexion vocalique	إتباع (الامالة في العربية نوع منه)
front vowel	voyelle d’avant ;voyelle antérieure	مصوت أمامي (من مقدم الفم)
full construction	construction pleine	تركيب تام
full stop	point (ponctuation)	نقطة (النهاية)
full verb	verbe non-auxiliaire	فعل تام
full voice	voisement complet	جهر تام
iunctional analysis	analyse fonctionnelle	تحليل وظيفي
functional and structural theory	théorie fonctionnelle et structurale	النظرية الوظيفية البنوية
functional change	changement phonémique changement catégoriel	تحول وظيفي تحول صوتي تحول من جنس إلى آخر
functional classidication	classification fonctionnelle	تصنيف وظيفي
functionalism	fonctionalisme	النظرية الوظيفية
functional linguistics	lingistique fonctionnelle	اللسانيات الوظيفية
fonctional load/yield	rendement fonctionnel	مردود وظيفي
fonctionnal meaning	sens fonctionnel	معنى وظيفي
functional moneme	monéme fonctionne	عنصر دال (أو منوم) وظيفي
functional shift	changement fonctionnel	كلمة وظيفية
functions of duration	fonction de la quantité	وظائف المد
functions of language	fonctions du langage	وظائف اللغة
functions of pitch	fonctions de la hauteur mélodique	وظيفة طبقة الصوت
functions of stress	fonction de l’accent	وظائف النبر
functives	fonctifs	حدا الوظيفة
functors	foncteur	عامل
fondamental frequency	fréquence fendamentale	تردد أساسي
fondamental pitch	hauteur mélodique  fendamentale	طبقة الصوت الأساسية
fondamental tone	ton fendamental	نغمة أساسية
fusion	fusion	انصهار صياغة واحدة
fusional language	langue fusionante	لغة انصهارية لغة صياغية
future	futur	المستقبل
future particle	particule de futur	أداة استقبال
		
		
		
		
		
		
		
		
		
		
		
		
		
geminate	geminé	مضعف مشدد
gemination	gémination	تضعيف (للصوامت) تشديد) في الكتابة)
geminative contraction	contraction géminative	إدغام
gender	genre	تذكير وتأنيث
gender noun	nom génirique	مؤنث أو مذكر معنوي
genealogical classification	classification génélogique	تصنيف سلالي
general grammar	grammaire générale	النحو العام
generalized transformation	transformation généralisée	تحويل معمم
general linguistics	linguistique générale	اللسانيات العامة
general semantics	sémantique générale	علم المعاني العام (علم دلالة المعاني)
generation	génération	توليد
generative grammar	grammaire générative	نحو توليدي
generative phonology	phonologie générative	فونولوجيا توليدية
generative semantics	sémantique générative	علم المعاني التوليدي
generic grammatical category	catégorie grammaticale générique	جنس نحوي
generic term	terme générique	اسم جنس عام
generous plural	pluriel	توكيد الجمع
genetic classification	classification génétique	تصنيف سلالي
genetic phonetics	phonétique historique	الصوتيات التاريخية
genetic relationship	relation génétique	علاقة وراثية
genetic case	cas génétique	حالة الإضافة (مضاف ومضاف إليه)
geographical classification	classification géographique	تصنيف جغرافي
geographical dialect	dialect régional	لهجة إقليمية
geographical linguistics ;geolinguistics	geolinguistique	اللسانيات الجغرافية
geround	gérendif	مصدر فعلي (في اللاتينية والإنكليزية مثلا)
gestural language	langue gesturelle	لغة الإيماء
ghost form	vox nihili ;barbarisme	صيغة محرفة
gingival	gingival	لثوي
glagolitic alphabet	alphabet glagoltique	نظام الكتابة  الكلاكوليتية  (في السلافية قبل استعمال السيريلية)
glide	glide ;son de transmition	صوت انتقالي  حرف لين
gloss	glose	كلمة موضحة
glossary	glossaire	مسرد لغوي
glossmatics	glossématique	تحليل اللغة  كلوسماتية
glosseme	glosséme	كلوسيم (أصغر وحدة ذات معنى)
glossogram	palatogramme	حنكية (رسم حنكي)
glossolalia	glossolalie	كلوسوليليا لغة سرية خاصة)
glottal	glottal	حنجري
glottal catch	coup de glotte	همزة محققة
glottalic air -stream	colonne d’air glottique	تيار هوائي حنجري
glottatic closure	fermeture glottale	إغلاق حنجري
glottalization	glottalisation	همز نبر
glottalized	glottalisé	مهموز
glottal stop	coup de glotte	همزة
glottis	glotte	فتحة المزوار (فجوة مثلثة بين الأوتار الصوتية)
glottochronology	glottochronologie	تاريخ التشعب اللغوي
glottograph	vibreur glottal	مهزاز حنجري
glottopolitics	linguistique institutionnelle	اللسانيات السياسية
gnemic resent tense	gnomique	صيغة الثبوت مضارع (للدلالة على العادة والتكرار)
geothic alphabet	alphabet geothique	ألفبائية غوتية
gevernee	gouverné	معمول
governement	governement	عمل
governement binding theorie	théorie de gouvernement et de liage	نظرية العامل الأمريكية
govenor	gouverneur	عامل
gradation	gradation	تدرج (مصوتي)
graded area	air de convergence (transmition)	منطقة تدريجية منطقة التلاقي (لغات ولهجات)
grading	classification graduelle	تصنيف تدريجي
graduel opposition	opposition graduelle	تقابل تدريجي
grammar	grammaire	النحو
gramar –translation method	enseignement par la traduction	طريقة القواعد والترجمة (في تعليم اللغات الأجنبية)
grammatical alternation	alternance grammaticale	تناوب نحوي
grammatical borrowing	emprunt grammatical	صيغة دخيلة
grammatical category	catégorie grammaticale	فصيلة نحوية
gramaticality ;grammaticalness	grammaticalité	السلامة النحوية
grammaticalization	grammaticalisation	تحويل إلى أدوات
grammatical meaning	sens grammatical	المعنى التركيبي
grammatical moneme	monéme grammatical	دالة نحوية
grammatical stress	accent grammatical	نبر نحوي
grammatical structure	structure grammaticale	بنية نحوية
grammatical unit	unité grammaticale	وحدة نحوية (وحدة التركيب اللغوي)
grammatology graphics	graphologie	علم الكتابة الوظيفي
grammeme (tagmeme)	gramméme	وحدة نحوية
grammatics	licence poétique	الضرورة الشعرية
graphema ;grapheme	graphème	وحدة خطية  حرف خطي  (في مقابل حرف صوتي)
graphemics ;graphology	graphologie	خطاطة (علم دراسة الخط)
graphic sign	signe graphique	علامة كتابية
Grassmann’s law	loi de Grassmann	قانون كراسمان
grave phoneme	phonème grave	صوت ثقيل ( في مقابل الحاد)
grave phoneme	phonème grave	ثقيل(مقاب حاد)
grat english vowel shift	grande mutation vocalique(du vieil anglais)	تحول المصوتات الإنكليزية في العصر الوسيط
Grimm’s law	loi de Grimm	قانون "كريم"
groove fricative (sibilant)	fricative a langue en creux	صفيري
groundless	immotivé	غير مسبب
group	groupe (syntagmatique)	مجموعة  (في تركيب)
group –inflected language	langue flexipnnelle	لغة تصريفية
guttural	guttural	حلقي
		
		
		
		
		
		
		
		
		
		
		
		
		
habitual aspect	aspect habituel	المتكرر (كيفية حدوث الحدث)
half-close vowel	voyelle mi-fermée voyelle demi-fermée	مصوت نصف   مضيق
half-open vowel	voyelle mi-ouverte voyelle demi-ouverte	مصوت نصف  موسع
half-rounded vowel	voyelle mi-arrondie	مصوت نصف  مضموم
haplography	haplographie	حذف  تصحيفي
haploogy	haplogie	حذف  اختزالي
hard consonant	consonne dure	صامت  صلب
hardening	durcissement	تجميد تشديد
hard ;non palatalized	non-palatisé	صلب  (في المصوتات غير ممال)
hatd palate	palais dur	حنك صلب (سقف الفم في مقابل سقف الحلق)
hard signe	signe dans l’alphabet syrillique. signe pour non-	علامة عدم الترقيم
harmonic	harmonique	التوافقيات
hearing	ouïe	السمع
hearing defect	défaut de l’ouïe	نقص سمعي
heavy stress	accent principal ;accent d’énergie	نبر رئيسي
helper verb	verbe auxiliaire	أداة فعلية
hemistich	hémistiche	مصراع
hésitation form	marque de l’hésitation (e-g-euh !)	صيغة تردد صيغة الاستعانة
hetroclite	hétéroclite	غير مطرد
heterograph	hétérographe	مختلف الكتابة
heterographic spelling	orthographe hétérographique	تهجئة متعددة النطق
heteronomous sound change	changement phonétique hétéronomique	تحول صوتي  متجانس
heteronym	hétéronyme	متجانس (في المعنى)
heteronymous	heteronymique	تجانسي
heteronymy	hétéronomie	تجانس الأسماء
heteroorganic	hétérorgane	مختلف المخرج
hiatus	hiatus	فاصل بين مصوتين
hieratics	écriture hiératiqye	هيراطيقية (نوع من الكتابة المصرية القديمة)
hieroglyph	hiéroglyphe	رمز  هيروغليفي
hieroglyphic	hiéroglyphe	هيروغليفي
high-falling	intonation descendante	حادر بعد صعود
high-low-back	haut-bas-arriére	مرتفع واطئ مؤخر (في مقابل مقدم)
high palte	palatine (voute)	الحنك الأعلى (قبة الحنك)
high vowel	voyelle haute	مصوت مرتفع (يرتفع فيه اللسان)
historical grammar	grammaire hitorique	النحو التاريخي
historical linguistics	linguistique historique	اللسانيات التاريخية
historical phonetics	phonétique historique	الصوتيات التاريخية
historical phonology	phonologie historique	فونولوجيا تاريخية
historical present	présent  historique	مضارع تاريخي (في سرد الأحداث)
hitorical semantics	sémantique historique	علم المعاني التاريخي
hold	tenue (dans l’articulation d’un son)	امتداد الحبس (المرحلة الأولى هي الحبس والمرحلة الأخيرة هي الاطلاق)
holiding period	urée de la tenue	مدة الحبس
holes in the pattern	cases vides	- ثغرات في النمط - خانات فارغة في النظام
holophrase	holophrase	جملة مفردة
holophrastic language	langage holophrasitique	لغة الجمل المفردة
homeotelenton	homéotélenté	سجع
homogene	homogéne	مطرد
homogloss	homogloss  (dictionnaire)	معجم لغات متحد الكتابة
homogram	homogramme	تهجئة مشتركة
homograph	homographe	متحد الكتابة
hompgraphy	homographie	اشتراك في الكتابة
homonionym	synonymie incompléte	شبه ترادف
homonym	homonyme	مشترك لفظي
homonymic clash/conflit	conflit homoymique	تضارب المشتركات
homonymy	homonymie	اشتراك لفظي
homophone	homophone	مشترك صوتي
homophonic clash	conflit homophonique	تضارب المشتركات الصوتية
homophoniy	homophonie	تماثل الصوت
homorganic phonemes /sounds	phonéme (sons),homorganes	وحدلا صوتية متجانسة المخرج
homotopical	homotopique	متحد المخرج (مع غيره)
honorfic form	forme honorifique	صيغة التبجيل
human noun	nom humain	اسم عاقل
hushing sodun	chuintante	حرف التفشي  صوت متفش
hybrid language	langue hybride	لغة هجينة
hydronymy	hydro-onamastique	دراسة أعلام الأنهار والبحيرات
hypallage	hypallage	مشاكلة
hyperbaton	hyperbaton	مخالفة الترتيب
hyperbole	hyperbole	مبالغة
hyper-correction	hypercorrection	حدلقة (فرط التصحيح)
hyperform	hyperforme	صيغة متحذلقة (صيغة مبالغ في تصحيحها)
hyper-urbanisme	hyperurbanisme	حذلقة (فرط التصحيح)
hyphen	trait d’union	علامة الوصل (بين الكلمتين)
hypocirism	hypocorisme	أسلوب التلميح
hypocroristic	hypocoristique	صيغة التحنن
hyponym	hyponyme	-نوع  (تحت الجنس) -فرد الجنس
hyponymy	hyponimie	نوعية (نسبة إلى جنس)
hypostasis	hypostase	-تحول الباب -تحول الجنس
hypotatic clause	phrase subordonnée	-عبارة وصلية -جملة محمولة
hypotaxis	hypotaxe	ربط بالأدوات
hypothetical clause	subordonnéz hypothétique	جملة شرطية  تقديرية
		
		
		
		
		
		
		
		
		
		
		
iamb (foot)	pied (poésie) ;iambe	وحدة شعرية (يامبو)
iconic	icone	أيقونة(ضرب من الكتابة التصويرية) أمثولة (صورة ذات دلالة)
		
iconography	iconographie	دراسة الأيقونات
ictus	ictus	جزء منبور
identification of languages	identification des langues	تشخيص هوية اللغات
identifying units	unités identificatrices	وحدات مشخصة
ideogram ;ideograph	idéogramme ;idéo	تهجئة تمثيلية
ideolect	idéolécte	(وحدة كتابية رامزة للفكرة)
idiom	idiome	لغة او لهجة  عبارة جامدة  (تجري مجرى الأمثال)
idiomatic expression	expression idiomatique	عبارة جامدة  تركيب مثلي
idiomatic translation	traduction idiomatique	نقل التركيب المثلي
idiomatic usage	usage idiomatique	استعمال مثلي
idiomatology	idiomatologie	دراسة العبارات المثلية  دراسة التعابير الاصطلاحية
idiophone	idiophone	أداء صوتي فردي (خاصية صوتية فردية)
idiophoneme	idiophonéme	صوت فردي (خاصة بلهجة الفرد)
idiosyncrasy	idiosyncrasie	سلوك لغوي فردي
illative	illatif	حكم الدخول في الشيئ (حالة إعرابية)
illiteracy	analphabétisme	الأمية
illiterate	illetré	أمي
illocutionary	illocutionnaire	إنشائي (في مقابل خبري)
imitation	imitation	محاكاة
imitation label	onomatopée ;mot imitatif	حكاية صوت
immanence	immanence	الباطنية (مبدأ دراسة اللغة داخليا)
immediate constituent	constituant immédiat	مكون مباشر
immediate speech	propos (parole) direct(e)	كلام عن حاضر
immigrant language/dialect	langue (dialecte) des émigrés	-لغة المهاجرين -لغة المغتربين
immovable speech organs	organes immobiles de la parole	أعضاء النطق الثابتة
imparisyllabic	imparisyllabique	مختلف المقاطع
imperatif	impérative	طلبي (بالأمر أو النهي)
imperfect	imparfait	غير تام
imperfective	imperfectif	فعل استمراري
imperfective aspect	aspect inaccompli	مضارع استمراري
impersonal verb	verbe impersonnel	فعل لا شخصي (فعل بلا فاعل)
implication	implication	لازم المعنى
implication	implication	إضمار
implosion	implosion	حبس  سكون
implosive	implosif	ساكن
impressionistic transcription	transcription impressionniste	كتابة انطباعية
improper compound	composé déclinable	مركب متصرف الأجزاء
improper speech	langage impropre ;argot	سوقية
impulse	impulsion	-تجزية -دفعة حرف
innaccentued	innaccentué	غير منبور
inactive voice	voix passive	بناء للمجهول
inanimate	inanimé	-غير حي -موات
incapsulating language	langue polysynthétique	-لغة تركيبية -لغة مزجية
incapsulation	incorporation	-إدماج -مزج
inceptive (inchoative) aspect	ichoatif	صيغة الشروع
included position	position d’inclusion	-موقع اندراج -موقع اشتمال
included sentence/utterance	proposition incluse	جملة مندرجة
inclusion	inclusion	-اندراج -اشتمال
inclusive first person ;inclusive personal pronoun	pronom ersonnel inclusif	ضمير المتكلم مع المخاطب (الشاملة للمخاطب)
incompatibility	incomptabilité	تنافر
incomplete verb	-verbe transitif -verbr défectif	-متعد -غير متصرف
incongruity	incongruité	عدم التوافق
incontignous assimilation	assimilation à distance	تقريب المتوقع
incroporating conjunction	conjonction de subordination	أداة الوصل  (أداة ربط أو حمل)
incroporating  language	langue polysynthétique	لغة مزجية
incorporation	incoroporation	-مزج -إدماج
incremential transformation	transformation incrémentielle	تحويل بزيادة معنوية
indeclinable	indéclinable ; invariable	مبني من حيث الإعراب فقط  جامد  (من حيث التصريف)
indeginite article/determiner	article(déterminant)  ;indéfini	أداة تنكير
indefinite   prounoun	pronom indéfini	ضمير تنكير
independent  clause	proposition indépendante	جملة مستأنفة
independent element	élément Independant	عنصر مستقل
independent sound change	changement phonétique indépendant	تحول صوتي مستقل
indigenous language	langue indigéne	لغة الأهالي
indirect discours/speech	discours indirect	أسلوب غير محكي
indirect objet	objet indirect	مفعول غير مباشر
indirect question	interrogation indirecte	استفهام تعليقي
individual variant	variante libre	بدل اختياري
indo-european	indo-européan	هندي أوروبي
induced	inducteur	محمول عليه
inducer	organe initiateur  (de (la phonation)	-العضو المحرك -العضو المحدث
inferior comparaison	comparaison  d’inferiorité	مفاضلة بالتنقيص
infinitive verb	verbe infinitf	فعل مصدري (في اللغات الأروبية)
infix	infixe	داخلة (داخل الكلمة)
inflected language	langue inflectionnelle	لغة ذات تصريف
inflectional affix	affixe de flexion	زائدة تصريفية
inflectional ending/suffix	désinence flexionnelle	لاحقة تصريفية  (علامة إعراب أو غيره)
inflextion/inflexion	inflexion	تصريف  إمالة
inflexible	indéclinable	مبني
informant	informateur ;informant	مورد
informatics	informatique(l’)	الإعلاميات  (أو المعلوماتية)
information	information	معلومات
information content	contenu de l’information	المضمون  المحتوى
information processing	trraitement de l’information	معالجة المعلومات
information theory	théorie de l’information	نظرية المعلومات
informém	informéme	فائدة (وحدة الإفادة)
infra-word	intra-mot	داخل الكلمة
ingressive stop	- occlusive ingressive (injective) -occlusive inspiratoire	-صامت داخلي - صامت شهيقي
inhalation	inhalation ;inspiration	شهيق
initial glide	glissement initial	صوت انتقالي من الأول
initial mutation	mutation à l’initiale	تحول في الأول
initial position	position initiale	الأول (مقابل الآخر)  الصدر
initial stress	accent (primaire ) à l’initial du mot	نبر في أول الكلمة
initial teaching alphabet	alphabet quasi-phonétique	ألفبائية تعليمية
injunctive	injonctif	أمر ونهي
inlaut	inlaut	وسيطي (في داخل الكلمة أو وسطها)
innate	inné	فطري
inner closure	occlusion ( fermiture) interne	انحباس داخلي
inner form	forme intern	النظام الباطني
innovation	innovation	-وضع مستأنف -طارئ
inordinated adjective	adjectif principal	نعت رئيسي
inorganic	non -original	غير أصلي
input	input	-داخل - وارد
inseparable affix	affixe non-séparable	زائدة لا تفصل
inserted clause	proposition incise	جملة معترضة
insiparation	insiparation	شهيق
instances of speech	instances du discours	تحصيل الكلام
instanciation	instanciation	البناء
instantaneous release	relâchement instantané	إطلاق فوري (في مقابل إطلاق مؤخر)
institutional linguistics	linguistique institutionnelle ; linguistique politique	اللسانيات السياسية
instrumental	instrumental	صيغة الاستعانة (حالة إعرابية)
instrumental phonetics	phonétique instrumentale	الصوتيات الاختبارية
instrumentative verb	verbe instrumental	فعل آلي (الذي يبين استخدام الآلة)
instrument of communication	instrument de communication	-آداة اتصال -أداة تبليغ
integration	intégration	إدماج
intensifier	adverbe de quantité	-صيغة تكثير -صيغة مبالغة
intension	1-sens (connotif ou dénotatif) 2-intension (sémantique)	1-المفهوم (في مقابل المصادق أو الذات) 2-المعنى المقصود
intensity	intensité	1-شدة الصوت  توتر العضلات
intensity accent	accent d’intensité	شدة النبر   نبر التوكيد
intensive language course	cours intensif de langue	-برنامج اللغة المكثفة -دروس لغة مكثفة
intensive prounoun	pronom d’intensité	-ضمير انعكاسي -ضمير الذات
interconsonantal	interconsonantique	ما بين الصوامت
interdental	interdental	-ما بين الأسنان -لثوي
interference	interférence	تداخل
interior language	langage intérieur	كلام النفس
interjected clause	incise	جملة معترضة
interjection	interjection	تعجب
interjectional théorie	théorie interjectionnelle	-نظرية التعجب (في أصل اللغات) -نظرية الأصوات
inter-language	interlingua ;interlangue	لغة اتصال دولي (بما فيها اللغات الاصطناعية)
interlinguistique	interlinguistique	دراسة العلاقات اللغوية
intermediate sound	son intermédiaire	صوت متوسط
intermediate structures	structure intermédiaires	مراتب التحويل
intermediate vowel	voyelle intermédiaire	مصوت متوسط
internal change	changement interne	تحول داخلي
internal hiatus	hiatus interne	التقاء داخلي لمصوتين
internal inflexion	inflexion interne	تصريف داخلي
internal loan	emprunt interne ; emprunt dialectal	دخيل لهجي
internal open juncture	jointure interne ouverte	وصل داخلي بالتراخي
internal punctuation mark	symbole interne de pounctuation	علامة الترقيم الداخلية
internal reconstruction	reconstruction interne	إعادة التركيب الداخلي
internal speech ;endophasia	endophasie	كلام باطني
international phonetic alphabet	alphaber phonétique international	ألفبائية صوتية عالمية
international words	mots internationaux	كلمات عالمية
interpretable	interprétable	يؤول
interpretative  component	composante interprétative	المقوم الحملي (في النحو التوليدي)
interpreter	interpréte	مترجم شفوي
interpreting	interprétariat	ترجمة شفوية
interro-emphatic	interro-emphatic	استفهام بالتقديم
interrogation mark	point d’intérrogation	علامة استفهام
intérrogative	interrogatif	استفهامي
interrogative adjective	adjectif interrogatif	صفة استفهامية
interrogative adverb	adverbe interrogatif	-قرينة استفهامية -أداة استفهام منفصلة
interrogative prounoun	pronom interrogatif	أداة استفهام منفصلة  خالفة استفهامية
interrogative sentence	phrase interrogative	جملة استفهامية
interrogative word	mot interrogatif	كلمة استفهامية
intero-negative	interro-négative	استفهام بالنفي
interrupted	interrupted	-حبسي  -آني (في مقابل ممتد)
interview	entrevue (enquête)  linguistique	مقابلة (لجمع المعلومات اللغوية)
intervocalic	intervocalique	بين المصوتين
intimacy	intimité	ألفة
initimate speech	langage intime	كلام استثنائي
intonation	intonation	1-تنغيم 2-نغمة الكلام (التغيرات التي تطرأ على درجة الصوت في الكلام المتصل)
intonation contour	contour de l’intonation courbe mélodique	منحى النغمة
intonation formant	formant de l’intonation	وحدة نغمية
intonation language	langue intonationnelle	لغة تنغيمية
intonation morpheme	intonéme	دالة تنغيمية
intonation pattern	courbe de l’intonation	نمط تنغيمي
intralanguage	intra-langue	داخل اللغة  (في تحليل الأخطاء)
intralinguistics feature	traits intralinguistique	صفات داخلية في اللغة
intraverbe verb	verbe intransitif	فعل لازم
interoductory adverb	conjonction adverbiale	-ظرف ممهد (لربط الجمل) -عطف قريني
interflexion	fléxion interne	تصريف داخلي
intrusion	intrusion	إقحام
intrusive R	R-intru	الراء المقحمة
intuition	intuition	وجدان (لغوي)
invariable word	mot invariable ; mot indéclinable	كلمة غير منصرفة
invariant	invariant	ثابت
inverse derivation	dérivation regressive	اشتقاق بالحذف
inverse spelling	orthographe inverse	تصحيح كتابي مغلوط
inversion	inversion	التقديم والتاخير (في كلم)  قلب مكاني   (في الأصوات)
inverted	inverti	مقلوب  متقعس (المخرج)
inverted commas	guillement	علامتا الاقتباس
inverted sound	son inverti ;son rétroflexe	مخرج تقعيسي
inverted word order	ordre inverti des mots	كلمات مقلوبة الترتيب
irradiation	irradiation	إشعاع (تاثير الأصل على معنى لاحق)
irregular	irrégulier	شاذ
irregularity	irrégularité	شذوذ
irregular verb	verbe irrégulier	فعل شاذ
irrelevant	non-partient	غير معتبر
irrelevant	non-pertient	تمثال زمني
isochronism	isochronisme	متساوي الفواصل (او الأجزاء)
isocolon	isocolon	متحد المؤدى (او المجرى أو الوظيفة)
isofunctional	isofonctionnel	بين لغوي (جون بيون)
isoloss ;isograph ;isolex	isoglosse	خط فاصل للهجات
isolate	1-mot-phrase 2-segement	جملة مفردة (كلمة تقوم مقام الجملة)  حرف مفرد
isolated area	aire isolée ;région isolée	منطقة معزولة
isolated opposition	opposition isolée	تقابل منفرد
isolating language	langue isolante	لغة عازلة
isolative sound change	changement phonématique isolé	تغير صوتي منعزل
isomorph	ismorphe	نظير (في البناء)
ismorphic line	ligne ismorphique	خط بيني تصريفي  (جامع أو حاصر لنظائر صرفية في الخارطة اللغوية)
ismorphism	ismorphisme	توافق البنية
isophone	isophone	بين صوتي (فاصل في نظام النطق)
isophonic line	ligne isophonique (d’isoglosse)	خط بين صوتي
isopleth	1-isoglesse  2-frontiére culturelle  (flokore)	بين لغوي ثقافي
isosyllabism	isosyllabisme	تساو زمني للمقاطع
isosyntagmic line	isosyntagmique ; ligne isosyntagmique	بين تركيبي  (خط فاصل في نظام الجملة)
isotonic line	ligne isotonique	بين تنغيمي (خط فاصل في نظام النغمة)
item	item	-عنصر لغة  -نحو (ضرب من الكلام)
item analysis	analyse par item	تحليل إلى عناصر
item-and-arrangement	item et arrangement	العنصر وانتظامه  (منهج تحليلي)
item –and-process	item et traitement ;item et processus	العنصر ومجاريه (منهج في التحليل اللغوي)
iterative aspect	aspect itératif	صيغة التكرار
iterative compound	composé itératif	مركب تكراري
iterative numeral	numéral intératif	عدد تكراري بالمضاعفة
		
		
		
		
		
		
		
		
		
		
		
		
		
		
		
		
		
		
		
		
		
		
		
		
		
		
		
		
		
jargon	jargon	رطانة
jargon aphasia	jargon aphasie	رطانة حبسية
jaw	mâchoire	فك
journalse	langue des journeaux ;style journalistique	أسلوب الصحافة
juncture	jonction	وصل  اتصال
jung grammatiker	nouveau grammarien	(مدرسة )  النحويين المحدثين
jussive mood	jussif	صيغة الأمر
juxposted compound	composé juxtaposé	تركيب انضمامي
juxtaposing language	langue à  juxtaposition	لغة انضمامية
juxtaposition	juxtaposition	انضمام
juxtapositional  assimilation	assimililation  juxtapositionnelle	تقرير للجوار
juxtapositional dissimilation	dissimilation  juxtapositionnelle	تبعيد للجوار
		
		
		
		
		
		
		
		
		
		
		
		
		
		
		
		
		
		
		
		
		
		
		
		
		
		
		
		
		
		
		
		
		
kernel sentence	phrase-noyau	الجملة النواة
key-word	mot-clef	-الكلمة المفتاح -الكلمة الأساسية
kinaesthetic feedback	feedback  kineesthétique	-ترجيع عضلي للنطق -ارتجاع حسي للحركة
kine	unité gestuelle	-وحدة إيمائية -كايني
kineme	kinéme	وحدة الإشارة الجسدية  1-وحدة إيمائية محصلة 2-الحركة في مقابل السكون (في النحو العربي -كاينيم
kinemics	kinesthésie	-دراسة إيمائية  -كينيمية
kinetics angles of the lawer jaw-bone	degré d’ouverture maxillaire	درجة انفتاح الفكين
kinetic consonant	consonne cinétique	صامت آني (لا يمكن مده)
kinetic vowel	voyelle cinétique	مصوت غير ثابت
kinship terms	nom de parenté	ألفاظ القرابة
koine	koiné	لغة مشتركة
kymogram	kymogrmme	ممواجية
kymograph	kymographe	ممواج (آلة تسجيل اهتزازات  الأوتار الصوتية)
		
		
		
		
		
		
		
		
		
		
		
		
		
		
		
		
		
		
		
		
		
		
		
		
		
		
		
		
		
labial	labial	شفوي
labialization	labialisation	ضم الشفتين
labialized velar	vélaire labialisé ;vélaire arrondi	صفاقي مضموم (من أعلى الحنك وضم الشفتين)
labiodental	labio-dental	شفوي من الثنايا العليا  شفوي أسناني
labiovelar	labio-vélaire	- شفوي صفاقي - طبقي شفوي
laboratory phonetics	phonétique instrumentale	الصوتيات المخبرية
lallation	lallation	-هلهلة -هديل
lambadacism	lambadacisme	لثغة اللام (استخدام اللام بدل من صوت آخر ،الراء عادة)
laminal	laminal	أسلي (الصوت)
language	langue	لغة  لسان
language  acquisition	apprentissage de la langue acquisition de la langue	اكتساب اللغة
langue barrier	obstacle linguistique	عائق لغوي
language boundary	frontiere linguistique	حدود لغوية
language change/shift	changement (mutation) linguistique	تحول لغوي
language  contact	contact des langues	تداخل اللغات
language devlopement	développement du langage	ارتقاء اللغة
language  faculty	faculté de  langage	القدرة على الكلام
language  family	famille de  langues	-أسرة لغوية - فصيلة لغوية
language laboratory	laboratoire de langue	مخبر لغة
language planning	planification linguistique	تخطيط لغوي
language standardisation	standardisation linguistique	توحيد لغوي  تفصيح
language starta	niveaux de langue	مستويات اللغة
language teaching	enseignement de la langue	تعليم اللغة
language universels	universaux du langage	كليات لغوية
langue	langue  (chez de saussure)	-لغة -لسان(عند دي سوسير)  (أو الوضع والاستعمال عند العرب)
lapse	lapsus	زلة
laryngeal	laryngé (ou laryngien)	حنجري (صوت)
laryngealized voicing	voisement laryngé	اهتزاز حنجري
laryngograph	laryngograph	راسم حنجري
laryngoscope	laryngoscope	مجواف حنجري
laryngostroboscope	stroboscope laryngal	مرداد حنجري
larynx	larynx	حنجرة (أقصى الحلق عند النحاة العرب)
lateral polsion	explosion latérale ;plosion latérale	انفجار جانبي (من حافة اللسان)
law of abreviation	loi d’abréviation	قانون الاختزال
lax	lâche	مرتخ لين
layering ;layered	disponible en couche	تنضيد (في المدرسة التاكميمية)
learned word	mot savant	كلمة عالمية (من وضع العلماء)
lenght	durant ; durée	-طول الصوت -المد
lenis	lenis ; lâche	ضعيف الاعتماد
lenition	lenition ;adoucissement	إضعاف صامت (تسهيل فيما يخص الهمزة وتليين فيما يخص الصوامت)
letter	lettre	حرف خطي
level	niveau	مستوى
levelling	nivellement (refaction) analigique	-طرد الباب  -حمل المطرد
level skipping	saut d’un niveau	إسقاط المستوى ( في المدرسة التاكميمية)
lexeme	lexéme	مفردة متمكنة
lexia	lexie	لفظة (في اصطلاح المدرسة الخليلية)
lexical category	catégorie lexicale	جنس معجمي  -قبيل إفرادي
lexical change	changement lexical	-تغير معجمي -تحول إفرادي
lexical cluster	groupe (suite) lexical(e)	نسق إفرادي
lexical entry	entrée lexicale	مدخل معجمي
lexical field	champ lexical	-حقل معجمي -مجال إفرادي
lexical item	item lexical	-وحدة معجمية -مفردة
lexicalization	lexicalisation	تلغية (تحول إلى كلمة مفردة)
lexical meaning	sens lexical	المعنى الوضعي (المعنى في أصل اللغة في مقابل المجازي وغيره)
lexicographer	lexicographe	معجمي
lexicography	lexicographie	-صناعة المعاجم -معجميات
lexicologist	lexicologue	-اللغوي -عالم متن اللغة
lexicology	lexicologie	دراسة المفردات (علم متن اللغة)
lexicon	lexique	-مجموعة من المفردات -متن اللغة
lexicostatistics	lexicostatistique	دراسة علم اللغة الاحصائي
lexis	lexis	-تحليل لفظي (خاص بالمفردات ) -مستوى التحليل الافرادي
liaison	liaison	وصل
ligature	lien (en écriture)	ربط (في رموز الكتابة)
light syllable	syllable légére ;syllabe non-accentuée	مقطع غير منبور
light vowel	voyelle légére	مصوت غير منبور
limitation	limitation (du contenu d’un cours de langue)	-حصر(في تعليم اللغات) -تخصيص المعنى
linearty	linéarité	-ترتيب تسلسلي للأصوات -تسلسل الكلام
linear opposition	opposition linéaire	تقابل المدرج
lingua franca	lingua franca	-لغة مشتركة -علجية مشتركة
linguagram	linguagramme	رسم اللسان
lingual	lingual	لساني
linguist	linguiste	-لساني -لغوي
linguistics  analysis	analyse  linguistique	تحليل لغوي
linguistic anthropology	anthropologie linguistque	-علم الانسان اللغوي انتروبولوجيا لغوية
linguistics  area	aires  linguistique	مناطق لغوية
linguistic atlas	atlas linguistique	أطلس لغوي
linguistique  change	changement linguistique ;mutation linguistique	تحول لغوي
linguistic chart	carte linguistique	خارطة لغوية
linguistic circle	cercle linguistique	حلقة لغوية
linguistic circle	cercle linguistique	سياق لغوي
linguistic demography	démographie linguistique	ديموغرافيا لغوية
linfuistic drill	exercice linguistique	تمرين لغوي
linguistic economy	économie linguistique	اقتصاد لغوي
linguistician	linguiste	-لساني -لغوي
linguistic norm	norme linguistique	معيار لغوي
linguistic philosophy	philosophie du  langage	فلسفة لغوية
linguistic psychology	psychologie du  langage	علم النفس اللغوي
linguistic  relativity	relativité  linguistique	النسبية اللغوية
linguistics	linguistique	-اللسانيات -علم اللسان
linguistics sciences	sciences linguistique ; sciences du langage	علوم اللسان
linguistics semantique	sémantique linguistique	علم المعاني اللغوي
linguistique sign	signe (symble) linguistique	علامة الدليل اللغوي
linguistic skill	aptitude linguistique	مهارة لغوية
linguistic taboo	tabou linguistique	محظور لغوي
linguistic typlogy	typologie linguistique	تصنيف لغوي (على أساس الخواص التركيبية)
linguoustylistics	stylistique linguistique	-علم الأسلوب -بلاغة
linkage	rattachement ;lien	ربط
linking	liaison	رابط
linking morpheme	morpheme de jointure  (mot composé)	عنصر ربط
linking R	R __ de liaison R__ épenthétique	راء الربط
linking verb	verbe copule	فعل ربط
linking word	mot coordonnant	أداة عطف
lip position	position es lèvres	وضع الشفتين
lip projection	projection des levres	تقبب الشفتين
lip rounding	arrondissement des lèvres	-تدوير الشفتين -ضم الشفتين
lip spreading	étirement des lèvres	جر الشفتين (عدم تدويريهما)
liquid	liquide	-مائع -حرف أذلق
lisping	zézayement ; blésement	لثغة الجيم (واللثغة بمعناها العام)
listing discrimination	discrimaination auditive	تمييز سمعي
ilst of frequency	liste de fréquence	قائمة تواترية
literacy  coefficient	coefficient d’alphabétisation	معامل القراءة والكتابة
litéral translation	traduction littéral	ترجمة حرفية
literacy language	lange littéraire	لغة أدبية
loan	emprunt	معامل ديني (تأثر لغة بأخرى بمعامل الدين)
liturgical language	langue liturgique	لغة دينية
loan	emprunt	-افتراض -اقتباس لغوي (كمصدر) دخيل (اللفظ المقتبس)
loan blend	fusion	مزيج اقتراضي
loan shift	intégration d’emprunt	-تحول اقتراضي -تحول الدخيل
loan translation	calque	اقتباس بالترجمة
loan word	emprunt	اقتباس لغوي
local friction	friction localisé	احتكاك عضوي
localization	localisation	مخرج النطق
locative	locatif	حالة المكانية
locus	locus	مورد الحرف (نقطة توارد)
logatome	logatome	مقطع
logical  construction	construction  logique	تركيب المعنى
logical subject	sujet réel (logique)	-فاعل حقيقي -فاعل معنوي
logogram ;logograph	logogramme	تهجئة لغوية (الرمز بدليل الكلمة  أو الكلمات)
logopedics	logopédie	تبليل (تقويم النطق  وإعادة البلة)
logorrhea	logorrhée	هذرمة
logosyllabic  writting	écriture  logosyllabique	كتابة مقطعية
logotactics	logotactique	تحليل سياقي
long consonant	consonne longue	صامت ممدود
long vowel	voyelle longue	مصوت ممدود
look-and-say	méthode « voir et prononcer »	منهج "انظر ثم انطق"
loquacity	loquacité  « acquisition de la langue »	مرحلة الثرثرة (في اكتساب اللغة)
loos of inflection	perte de l’inflexion ; chute de l’inflexion	فقدان التصريف
loudness	volume (puissance) sonore	جهارة الصوت
low formant	formant bas	البانية السفلى
low latin	bas latin ; latin vulgaire	لهجة لاتنية دارجة
low vowel	voyelle basse ; voyelle ouverte	مصوت واطئ
		
		
		
		
		
		
		
		
		
		
		
		
		
		
		
		
		
		
		
		
		
		
machine translation	tarduction automatique	ترجمة آلية
macron	signe de durée	علامة المد
macrosegment	macrosegment	منطوق بنغمة واحدة
macro-structures	macrostructures	البنى الأصلية
main clause	proposition principale	الجملة المحمول عليها
main verb	verbe principal	-فعل رئيسي -فعل محمول عليه
major class features ;distinctives features	traits distinctifs des catégories majeures	الصفات المميزة للأجناس الكبرى
major form class	partie majeure d’un mot	أحد الأقسام الرئيسية للكلمة -قبيل(قسم من أقسام الكلم)
majuscule	majuscule	حرف كبير
makeshift language	sabir	علجية مشتركة  (عند يسبرسن)
malapropism	catachrése	مجاز شائع
malformation	malformation	صياغة خاطئة
manner(mode) of articulation	mode d’articulation	صفة الحرف (في مقابل المخرج)
maner of discourse	modalité du discours	طريقة الكلام(وحكم الكلام إذا كان المقصود هو الإثبات والاستفهام والنفي وغير ذلك)
manner of formation	mode de formation	طريقة الصياغة
marginal	marginal	هامشي
marginal area	région (aire) marginal	منطقة هامشية
marginal element	élément marginaux (syllabe)	أطراف المقطع
marginal sounds	sons marginaux	أصوات هامشية (نادرة الوقوع)
mark	marque	علامة
marked member	membre marqué	عنصر معلم (في مقابل زذو علامة غير ظاهرة)
marker	marqueur	راسم (عند تشومسكي)
mark of correlation	marque de corrélation	علامة التناظر
Markov chaines	chaine de Markov	مسلسلات "مركوف"
masculine	masculin	مذكر
masking effect	masquage	-تغليب صوتي -تغطية
mass noun	nom non-comptable nom massif	اسم غير معدود
materiel content	contenu materiel (sens)	-المعنى المحصل (في مقابل اللفظ) -المحتوى
mathematical linguistics	linguistique mathématique	اللسانيات الرياضية
matrix sentence	phrase matrice	الجملة الأصل
matronymic	nom matronymic  (mqtrontyme)	اسم مشتق من اسم  الأم
meaning	sens	-معنى -مدلول
meaningful	significatif	ذو معنى
meaningless	non-significatif	بدون معنى
measure	mesure	تقطيع البيت
mechanical (machine) translation	traduction automatique	ترجمة آلية
mechanistic theory	théorie mécaniste (théorie anti-mentaliste)	النظرية الآلية
medial-accent	accent interne (médian)	نبرة وسطية
medial consonant	consonne médiane	صامت وسطي
medial position	position médiane	موقع وسط
median resonant	resonateur médian	رنان متوسط
mediopalatal	médiopalatal  ;médiodossam	شجري (أو من وسط الحنك)
médio-pharynx	médiopharynx	وسط الحلق
medium vowel ;neutral vowel	voyelle neutre	-مصوت محايد -مصوت مخفى (عند العرب)
melioration	amélioration ; mélioration	-معنى المدح -المدح
meliorative suffix	suffixe d’amélioration ; suffixe mélioratif	لاحقة للمدح
melloow	mat	-مصمت -رخيم
melody	mélodie  (de la phrase)	نغمة (الكلام)
mentalism	mentalisme	-الذاتية -الذهنية
mentalistic theory	théorie mentaliste	صيغة منحوتة
merged form	forme fusionnée	فعل مركب
message	message	-خطاب
metadiscourse	métadiscours	-خطاب فني -خطاب على خطاب
metalanguage	métalangue  ;métalangage	-اصطلاح  -وضع ثان (في مقابل الوضع الأول)
metalepsis	metalépse	كناية بالسبب (أو المسبب)
metalinguistic function	fonction métalinguistique	الوظيفة التحقيقية
metalinguistics	métalinguistique	-خاص بالوضع الثاني -خاص بالتحقيق في اللغة
metanalysis	métanalyse	-تحليل ثان -تحليل على تحليل
metaphone	métaphone	-بدل صوتي -بدل غير مقيد
metaphony	métaphonie	اتباع
metaphor	métaphore	استعارة
metaphrase	métaphrase ;phrase  littérale	ترجمة حرفية
metaplasme	métaplasme	-تغيير صوتي -تصحيت
metastase	métastase	إطلاق
metatheorie	métathéorie	-نظرية ثانية نظرية النظرية
metathesis	métathése	قلب مكاني
metonomy	métonymie	مجاز مرسل
metre	métre	وزن الشعر بحر في العروض
metrcis	métrique	علم العروض
microcontext	microcontexte	السياق القريب
microsegment	microsegment	-قطعة صغرى -وحدة صغرى
microsysteme	microsegment	-منظومة صغرى -بنى فرعية
microsysteme	microstructure	لغة وسطى
middle language (diglossia)	langue médiante	صيغة المطاوعة
middle voice	voix du réflexif	مصوت وسطي (مخفي عند العرب)
middle vowel (neutral vowel)	voyelle neutre	نظرية الانتشار
migration theory	théorie migratoire/ de la migration	-حكاية صوت -كلمة محاكية (الصوت الطبيعية)
mimicry	mimique	إيمانه
minimal definition	définition minimale	حد أدنى
minimal pair	paire minimale	-ثنائية صغرى  -زوج أصغر
minority language	langue minoritaire	لغة أقلية
miniscule	miniscule	حرف عادي
mixed language	langue mixte ;sabir ;pidgin ; créole	لغة مختلطة
mixed metaphore	métaphore mixte ; métaphore combiné	استعارة مختلطة
mixing og languages	mélange de langues	خلط اللغات
mixture	mixture	خليط لغوي
mobile stress	accent libre	-نبر متنقل -تطويح غير ثابت
mock form	néologisme humouristique	صيغة فكاهية
modal auxilary verb	verbe auxiliaire modal	-فعل مساعد -أداة فعلية
modal content	contenu modal	المعنى الحكمي  للكلام
modality	modalité	حكم الكلام  (استفهام-خبر-أمر-تمن) 2-الدواخل (في البنوية الوظيفية) 3-معاني النحو
modal predicate	predicat	جملة فعلية خبرية
mode	mode	-صيغة فعل -وزن
model	modéle	مثال
mode of articulation	mode d’articulation	صفة الحرف  (في مقابل المخرج)
mode of discourse	mode de discours	-صيغة الكلام -حكم الكلام
modification	modification	زيادة تخصيص  مفيدة
modified language	langue modifiée	لغة متغيرة
modifier	modificateur	مخصص مفيد (داخل على مفردة أو جملة)
modulation	modulation (prosodique)	-تصريف نغمي -تصريف تطويحي
momentary aspect	aspect ponctuel ; aspect momentané	الحدوث الآني
moneme	monéme	عنصردال  مونيم
monogenesis thesis/theory	théorie(thése) monogénistique	نظرية الأصل  الواحد
monoglot	monoglotte	أحادي اللغة
monogrel word	mot hybride	كلمة هجينة
monolateral	monolatéral	من جانب واحد (صوت)
monolingual	monolingue ;unilingue	أحادي اللغة
monologue	monologue	مونولوك (حديث فردي)
monomorphemic	monomorphé	أحادي الدالة
monophone	monophone	أحادي الصوت
monophonemic	monophonémtique	أحادي الحرف
monophthong	monophthongue	مصوت بسيط
monophthongization	monophthongaison	توحيد المزدوج  الصوت
monosemy	monosémie	أحادية الدلالة
monosyllabic	monosyllabic	أحادي المقطع
monosyllabism	monosyllabisme	ظاهرة أحادية المقاطع
monosyllable	monosyllabe	أحادي المقطع
monosytemic	monosytémique	أحادي النظام
monotonization	monotonisation	توحيد النغمة
mood	statut de la phrase	حكم الكلام (إثبات-نفي-استفهام-تعجب الخ)
mora	more	مقدار المدة مورة (وحدة قياس الطول  الصوتي)
morph	morphe	-صورة الدالة -الدالة المثالية
mpepheme	morphéme	-عنصر دال -دالة نحوية
morpheme alternant	morphoneme	-وحدة صرفية (عند مارتني) -بدل تصريفي
morphmiqueeme word	mot monomorph	كلمة أحادية  الدالة
morphemically conditioned –phonemic variation	alternace (variation) morphonémique	تعاقب صرفي  صوتي
morphemic analysis ;morphological analysis	analyse morphologique /morphématique	morphologieتحليل إلى دوال
morphemics	morphologie	-علم الصرف (عند العرب) علم الصيغ(في مقابل علم النحو التركيبي وعلم الأبنية التركيبية)
morphemic script	écriture morphémique ;logographie	كتابة تمثيلية
morphological assimilation	assimilation morphologique	-حمل بناء  على بناء -قياس صرفي
morphological change	changement morphomogique	تحول صرفي
morphological doublet	doublet morphologique	رسيلة صرفية
morphological extention	extention  morphologique	تفريغ الأبنية الصرفية
morphological variations	variations  morphologhique	تصاريف
morphology	morphologie	علم الصرف
morphoneme ; morpho-phoneme	morphophonéme	حرف مبني (وحدة صوتية صرفية)
morpho-phonemic  stress	accent morphophonémique	نبر صرفي صوتي  تطويح صرفي صوتي
morpho-phonemic variation	variation morphophonémique	تصريف صرفي صوتي
morpho-phonology	morphophonologie	علم الأصوات  الصرفي
morpho-semantic field	champ morpho-sémantique	مجال دلالي صرفي
mother tongue	langue maternelle	اللغة الأم
motorphonetics	phonétique articulatoire	صوتيات  المخارج
mouth cavity	cavité buccale	تجويف  الفم
movable speech organs	organes mobile de la parole	أعضاء النطق المتحركة
multi-dimensional phonology	phonologie multidimentionnelle	تحليل مستوى التطويح
multilateral opposition	opposition multilarérale	تقابل متعدد الأطراف
multilingualism	multilingualisme ;plurlingue	تعدد اللغات
multilingual ;polyglotte	multilingue ;plurilingue	متعدد اللغات
multilogue	multilogue	حديث جماعي
lultipartite system	systéme multipartite	نظام متعدد الأجزاء
multiple meaning	plurésémie ;polysémie	استراك (تعدد المعاني)
multiple sentence	phrase complexe	جملة مركبة
multiple substitution  frame	cadre à substitution multiple	جدول متعدد الاستبدال
multiplicative numeral	numéral ordinal	عدد ترتيبي
multi-segmental  feature	trait multisegmental	صفة لأكثر من حرف
multisyllable	polysyllabique ;polysyllabe	متعدد المقاطع
multiverbal endocentric structure	structure endocentrique	تركيب مشتمل على نظير
murmur vowel	murmure vocal	مصوت وسطي (مخفى)
mutation	mutation	تحول صوتي
mute	muet(son)	حرف غير  منطوق
mutual intelligibility	intercompréhension	تفاهم
mutually exclusive	mutuellement exclusive	متدافعان
		
		
		
		
		
		
		
		
		
		
		
		
		
		
		
name of instrument	nom d’instrument	اسم آلة
naming	appellation	تسمية
narration	narration	فعل الحكاية
nrrow diphtong	diphtongue étroite	مزدوج مضيق
narrowed  meaning	sens (étroit) restreint	المعنى الخاص
narrowing of meaning	restriction du sens	تخصيص المعنى
narrow trnscription	alphabet phonétique	نسخ صوتي  ألفبائية صوتية
narrow vowel	voyelle fermée	مصوت مضيق المخرج
nasal	nasal	خيشومي  -أغن (صفة للحرف)
nasal cavity	cavité nasale	الخياشيم (تجاويف الأنف)
nasal consonants	consonnes nasales	صوامت غناء
nasality	nasalité	غنة
nasalization	nasalisation	إغنان (إشراب الحرف غنة)
nasalized	nasalisé	مغن (مشرب غنة)
nasalization vowel	voyelle nasale	مصوت أغن
nasal pharynx	pharynx nasal ; rhinopharynx	تجويف الحلق  الخيشومي
nasal plosion	plosion nasale	انفجار من الخيشوم
nasale release	relachement nasal	إطلاق من الخيشوم
nasal sound	son nasal	صوت أغن
nasal twang	nsillement	-تأنيف (في النطق الإقليمي) -إشراب الكلام غنة
native language	langue native	لغة المنشأ
native speaker	locuteur natif	فصيح (بالفطرة)
native word	mot natif	كلمة أصلية
nativistic theory	théorie nativiste	نظرية محاكاة الأصوات
natural gender	genre naturel	جنس طبيعي (من حيث التذكير والتأنيث)
naturalized word	mot integré emprunt intégré	-دخيل مؤقلم -دخيل موطن (كلمة)
near person	proche personne	القريب (المتكلم والمخاطب)
near synonym ; pseudo-synonym	pseudo-synonyme	-مرادف تقريبي -شبه مرادف
negation	négation	النفي
negative conjunctions	conjonctions négatives	أدوات نفي الربط
négative particle	particule négative	أداة نفي
negative transformation	transformation de négation	تحويل للنفي
neogrammarians	néogrammairiens	النحاة المحدثون
neologism	néologisme	مولد
neology	néologie	توليد
nesting	echassement multiple	تضمن متعدد
neurolinguistics	neurolinguistique	اللسانيات العصبية
neutralizable oppositions	oppositions neutralisables	متقابلات قابلة للالغاء
neutralization	neutralisation	إلغاء
neutral vowel	voyelle neutre	مصوت وسطي (مخفى عند العرب)
nexus	nexus	1-تركيب 2-نواة
noa word	mot euphémistique; euphémisme	كناية تنزيه
node	noeud	-نقطة تفريع -عقدة
noeme	glosséme	نؤيم (معنى الكلوسيم)
noise	bruit	1-تشويش 2-قرع ( في الصوتيات ويقابله النغم)
nominal definition	définition explicative	تعريف بالشرح
nominalism ; conventionalism	nominalisme	-الاسمية -الاسمانية
nominalization	nominilisation	تحويل إلى اسم
nominalizator	nominilisateur	زيادة للاسمية
nominam (noun) clause	phrase nominale	جملة اسمية
nominal phrase	locution nominale	-تركيب اسمي -مجموعة اسمية
nominal sequence	suite nominale	-مساق اسمي تسلسل اسمي
nominative case	cas nominatif	-حالة الفاعل  -حالة المسند إليه
non-anterior	non-antérieur	-غير أمامي -غير مستقل
non-automatic alternation	alternance  non-automatique	تعاقب غير اضطراري
nonce-form	néologisme éphémére	-صيغة مبتكرة -مولد عارض (قاصر الحياة)
non-consonantal	non-consonantique	غير صامت
non-contiguous assimilation	assimilation  non -contigue	مماثلة تباعدية
non-continuant	non-continu	1-غير متصل (حدوث الفعل) 2-غير زماني (مصوت)
non-contrasting variant	variante non-contrastive	بدل بلا تفاضل
non-contrastive distribution	distribution non-constrative	قسمة بدون تفاضل
non-count noun	nom non-comptable	اسم غير معدود
non –definite article	article indéfini	أداة تنكير
non-distinctive feature	trait non-distinctif	صفة غير مميزة
non-distinctive oppositions	oppositions non-distinctives	متقابلات غير مميزة
non-favorite(minor) sentence	phrase mineur	جملة مفيدة صغرى
non-finite(infinite) verb form	forme infinitive	فعل مصدري
non functional feature	trait non –fonctionnel ; trait non-pertinent	صفة غير وظيفية
non funtional redondance	redondance non-fonctionnelle	-تطويل -حشو
non-functionl variation	variation non-fonctionnelel	تنوع غير وظيفي
non-human noun	nom non-humain	اسم غير العاقل
non-immediate situation	situation non-immédiate ; situation distante	حال الخطاب غير قريبة
nin-liner	non-linéaire	-غير متوال -غير متسلسل
non-motived	non-motivé	غير مسبب
non-nasal	non-nasal	غير أغن
non-periodic vibration	vibration non-périodique	غير دوري (اهتزاز)
non-phonemic	non-phonémique ;allophonique	غير لفظي
non-productive	improductif	-غير مقيس -جامد
non-restrictive	non-restrictif	غير محصور
non-sense forme	forme sans signification	صيغة لا معنى لها
non-sharp	non-diésé (consonne faible)	غير مرفوع
non-significant	non-significatif	غير دال
non-standard	non-standard	غير فصيح
non-syllabic	non-syllabique	لا مقطعي
non-vocalic	non-vocalique	غير مصوت
norm	norme	معيار
normalization	normalisation	تقعيد (إثبات الأصول اللغوية)
normative linguistics	linguistique normative	اللسانيات المعيارية
notation	notation	كتابة باستخدام الرموز
notional (philosophical) grammar	grammaire  notionnelle	نحو فلسفي مفهومي
notional word	mot plein	كلمة متمكنة
noun	nom	اسم
noun adjunct	nom modificateur	اسم زائد (يغير المعنى)
noun cluster/phrase	phrase	تركيب اسمي
number	nombre	عدد (في النحو)
numeral	numéral	عددي
numerative classifier	numéral ordinal	عدد ترتيبي
nunation	nounation	تنوين
		
		
		
		
		
		
		
		
		
		
object complement ;object	complément d’objet ;objet	مفعول به
objevtive case	cas objet ;cas régime	حال المفعول
objective prounoun	pronom objet	ضمير المفعول
obligative mood	mode ordre	صيغة الأمر (في مقابل النهي)
obligatory categories	catégories obligatoires	أجناس واجبة
obligatory rule	régle obligatoire	قاعدة إلزامية
obligatory transformation	transformation obligatoire	تحويلة إلزامية
obligatory variante	variante obligatoire	بدل اضطراري
oblique case	cas oblique	حالة غير الفاعل
oblique(indirect)  question	interrogation indirecte	استفهام تعليقي
observational adequacy	adéquation d’observation	استيفاء المشاهدة
obsolescence	obsolescence	ترك
obsolescent	obsolescent	آيل إلى الترك
obsolete	obsoléte	-متروك -ممات
obstruent	obstruent	معترض
obviative	obviatif ;anontif	ضمير الغائب
occlusion	occlusion	-انسداد (لمجرى الهواء) -حبس (صفة للحرف)
occurence	occurence	-وقوع -حدوث
of-glide ;final glide	glide final	1-النقلة الأخيرة (الخروج الأخير) 2-الصويت
on-glide	glide initial	الابتداء (الخروج الأخير)
onomasiology	onomasiologie	علم المعاني فير اللفظي (دراسة الأدلة انطلاقا من المعاني)
onomastics ;onomatology	onomastique	دراسة الأعلام
onomathesia	onomastique	تسمية
onomatopeia	onomatopée	حكاية صوت
onomatopoeic theory	théorie onomatopéique	نظرية حكاية الأصوات
onset	début de syllabe	بداية المقطع
ontogeny	ontogénie	دراسة تطور لغة الفرد
open approximant ;frictionless continuant	consonne contiuante non-r=fricative	مصوت ممتد غير تسريبي
open-class words	mot à classe ouverte	الكلمات غير المحروصة
open construction	construction ouverte	تركيب غير محدود
open juncture	joncture ouverte	اتصال متراخ (في مقابل الاتصال الشديد)
open list/set	liste ouverte	قائمة مفتوحة (قابلة للزيادة)
open syllabification	syllabation ouvertre	نظام المقاطع المفتوحة
open transition	transition ouverte	اتصال متراخ
oepn vowel	voyelle ouverte	مصوت متسع المخرج
operande ;operator	opérateur	-عامل -عنصر تركيب
opposition	opposition	-تقابل -متقابلة
opposition of localization	opposition de localisation	متقابلات في  المخرج
opposition of mode	opposition de mode	متقابلات في الصفة
optative mood	mode optatif	صيغة التمني  (للفعل)
optional element	élément facultatif	عنصر اختياري
optional transformation	transformation facultative	تحويلية اختيارية
optional variant	variante facultative	بدل جائز
oral	oral	شفوي (عكس كتابي)
oral air-mechanism	mécanisme d’air oral	مجرى الهواء في الفم
oral cavity	cavité orale/buccale	تجويف الفم
oral literature	littérature orale	أدب شفوي
oral sound	son oral	صوت فموي
oratorical interrogation	interrogation oratoire	استفهام تقريري
oratorical speech	langage cérémonial	-كلام تقليدي -كلام خطابي
order	ordre/série( de sons) ordre des mots	1-ترتيب (المخارج) 2-ترتيب الكلمات
ordinal number	numéral ordinal	عدد ترتيبي
ordinary language	langue ordinaire	لغة عادية
prgans of speech	organes de la parole	أعضاء النطق
origin of language ;origin of speech	origine de la parole	-أصل الكلام -أصل اللغة
oro-pharynx	oro-pharynx	أدنى الحلق
orthoepy	orthoépie	دراسة النطق الفصيح
orthography ;spelling	orthographe	-نظام التهجئة -النظام الإملائي
oscillogram	oscillogramme	مهزازية (رسم الذبذبات)
oscillograph	oscillographe	-مهزاز راسم -راسم الذبذبات
oscilloscope	osciloscope	مهزاز
ostensive definition	définition ostensive	تعريف بالإشارة (إلى الشيء)
outer closure	fermeture externe ;occlusion externe	-تضييق خارجي -حبس خارجي
outer form	forme éxterieur	النظام الخارجي (نظرية هومبلولت)  (في مقابل النظام الباطني)
overall pattern	modèle (systéme) général	-نظرية تفسيرية عامة -تمثيل عام
over-coreection	hypercorrection	-فرط التصحيح -تصحيح مغلوط
over differentiation	excés de diffénciation ; différenciation exagrée	فرط التمييز
overlap	chevauchement ;double  emploi	تداخل
overlapping distribution	distribution à chauvchement	قسمة ذات تداخل
overtone	connotation	دلالة المعنى
oxymoro	oxymore	-تضاد -تكافؤ
oxytone	oxyton	-مطوح الآخر منبور الآخر
		
		
		
		
		
		
		
		
		
		
		
		
		
		
		
		
		
		
		
		
		
		
		
		
		
		
palatal	palatal	-شجري -حنكي
palatalization	palatalisation	-تشجير -تحنيك
palate	palais	حنك
palato-alveolar	palato-alvéolaire	-شجري نطعي -حنكي نطعي
palatogram	palatogramme	-حنكية رسم حنكي
palatograph	palatograph	محنك
palatpgraphy	palatographie	حنكيات
paleography	paléographie	علم الخطوط والحنكيات القديمة
palindrome ;anagram	palindromé	لفظة تقرأ طردا وعكسا
paradigm	paradigme	-جدول التصريف -مثال
paradigmatic economy	économie paradigmatique	اقتصاد في  التصريف
paradigmatic pattern	modèle paradigmatique	نمط تصريفي
paradigmatic sound change	changement phonétique paradigmatique	تحول صوتي تصريفي
paragogue	paragogé	إلحاق تسهيلي
paragrammatism	paragrammatisme	عسلطة نحوسة (عفك أو ثغثغة)
paralanguage	paralangage	خارج عن اللغة
paralexy	paraléxie	-عسلطة قرائية -عفك القراءة
paralinguistics	paralinguistique	دراسة الظواهر  شبه اللغوية
paraphrase	paraphrase	-مجاز جملة -وجه تعبيري
paraphrastic	paraphrastique	وجوه التعبير (عن المعنى الواحد)
paraplasm	paraplasme	صيغة طارئة
parasitic ;epznthetic	parasite ;épenthétique	-صوت مقحم -صوت متطفل
parasitic vowel	voyelle parasite ; voyelle épenthétique	مصوت متطفل
parasynthesis	parasynthése	-اشتقاق باللواصق
parataxis hypotaxis	parataxe	فصل (في مقابل الوصل)
parenthesis	parenthése	قوسان
parenthetic clause	proposition enchassée	-جملة مدمجة (في أخرى) -جملة مضمنة
parenthetization	parenthétisation	التقويس
parent language	langue parente	اللغة الأصلية
parisyllabic	parisyllabique	متساوي المقاطع
parole	parole	كلام
paronomasia	paronomase	-اتباع -ازدواج
paronym	paronyme	مشترك الجذر
paroxytone	paroxyton	منبور ما قبل  الآخر
paroxytonic language	langue paroxytonique	لغة مطوحة ما قبل الأواخر
parasing	analyse grammaticale	إعراب (بتحليل الجملة)
partial assimilation	assimilation partielle	تقريب جزئي  (مشاكلة جزئية،مضارعة أو تجانس)
partial complementationn	complémentarité partielle	تكامل جزئي
partial interrogation	interrogation partielle	استفهام تصوري
participal phrase	syntagme participal	1-مجموعة اسم الفاعل 2-مجموعة اسم المفعول
particle	particule	أداة
partitive article/gentive	article partitif	أداة تبعيض
partitif numeral	nom de fraction	-اسم كسر -جزء
parts of speech	partie du discours	أقسام الكلام
pasigraphy	systéme d’écriture (à symboles quasi-universels)	كتابة عامة (نظام الكتابة باستخدام رموز عامة)
pasimology	systéme gestuel de communication	نظام الاتصال بالاشارات
passive	passif	-مبني للمجهول -مبني للمفعول
passive articulator	articulateur immobile	عضو النطق الثابت
passive cavity	cavité immobile	تجويف ثابت
passive infinitive	infinitif passif	مصدر مبني للمجهول
passive voice	voix passive	صيغة المبني للمجهول
past(past tense)	passé (le)	ماض
past antérior	passé antérieur	ماض سابق
past historic	passé historique ;passé simple	ماض منقض
past participle	participe passé	صيغة اسم المفعول
past perfect	plus-que-parfait	الماضي المركب الثاني
patois	patois	لهجة محلية
patronymic	patronyme	اسم منسوب إلى الأب
pattern conguity	congrence (congruite) de la pattern (du systéme)	-اتساق النمط -اطراد المثال
pattern drill	exercice systématique	-تدريب على الأنماط -تدريب على القياس
pattern pressure	pression du systéme	موجب القياس
paucal number	nombre du paucité	جمع القلة
pause	pause	حالة الوقف
pause pitch	hauteur mélodique de la pause	درجة الصوت في الوقف
peak of senority/prominence	sommet de sonorité	قمة الجهارة
peak satelite	partie non-accentuée du sommet	مصوت تابع
pedagogical grammar	grammaire pédagogique	نحو تعليمي
pedagogical languistics	linguistique pédagogique pédagolinguistique	اللسانيات التربوية
pedigree theory	théorie de l’arbre généalogique	نظرية التشعب اللغوي
pejoration	péjoration	الذم(في مقابل المدح)
pejorative	péjoratif	معنى مذموم
penlut	pénultiéme	المقطع قبل الأخير
peregrinism	emprunt à une langue étarngére	اقتباس لغوي
perfect tense	passé composé	-الماضي المركب الأول -الماضي المبهم
performence	performence	أداء
performative	performatif	إيقاعي
period	période	1-دورة (في الصوت) 2-وصل في البلاغة
peripheral language	langue de contact	لغة التخوم
perpheral vowel	voyelle cardinale	مصوت ركن
periphrasis	périphrase	إرداف
perlocutionary	perlocutoire	حالي (مدلول عليه) بدلالة الحال
permansive apect	aspect permansif	أفعال الإذن
permanssive verbs	verbes permenssifs	عناصر متعاقبة (يقوم بعضها مقام بعض أو بدل بعض)
permutation	permutation	قلب مكاني
permutative	permutatif	طرد عكسي
person	personne	-شخص -إنسان
personal endings	désinences personnelles	علامات الإضمار
personal prounoun	pronom personnel	ضمير
personal verb	verbe personnel	فعل ذو ضمير
personification	personnification	تشخيص (تنزيل غير الآدمي منزلة الآدمي)
pertoglyph	pétrographie	نقش حجري
petrogram	pétrogramme	-تهجئة حجرية -نقش حجري
phantom word	idiotisme ;forme fautive	-مثل (عنصر جامد) -توهم(عنصر متوهم فيه)
pharyngeal	pharyngal (h)	محض حلقي
pharyngeal air stream-mechanism	mécanisme d’air-pharyngal	مجرى الهواء في الحلق
pharyngeal cavity	cavité pharyngale	تجويف حلقي
pharyngalization	pharyngalisation	إطباق
pharynx	pharynx	-الحلق -الحلقوم
phatic communion	fonction phatique	-وظيفة تفعيلية -وظيفة عطفية
phonotype	phonotype	فرع
philology	philologie	فقه اللغة (دراسة اللغة القديمة)
philosophie of language	philosophie du langage	فلسفة اللغة
phonation	phonation	تصويت
phone	phone	1-إصاتة 2-صوت محصل
phomematic ;phonemic	phonématique	-حرفي -فونولوجي
phonematics	phonématique	-علم الوحدات الصوتية -الصوتيات الوظيفية
phonematic unit	unité phonématique	-حرف صوتي -وحدة فونولوجية
phoneme	phonéme	-وحدة صوتية -حرف صوتي (فونيم)
phoneme-grapheme correspendance	phonéme-graphéme	تطابق لفظي خطي
phonemically conditioned alternation	alternance phonémique conditionné	تعاقب صوتي اضطراري
phonematic alphabet	alphabet phonématique ;alphabet phonémique	الأفبائية صوتية
phonemic analysis	analyse phonématique ;analyse phonémique	-تحليل إلى حروف صوتية -تحليل فونيمي
phonemic change	changement phonologique/phonémique	-تحول فونيمي  -تحول نظام الحروف الصوتية
phonemic contrast	opposition phonémique ;opposition phonologique	-تقابل فونيمي -متقابلة حرفية
phonemicist	phonémiciste	عالم الفونيمات (متخصص في الصوتيات الوظيفية)
phonemic loan	emprunt phonémique ;emprunt phonologique	اقتباس صوتي
phonemic/natation/ transcription	notation(transcription) phonémique	-كتابة صوتية حرفية -كتابة صوتية فونيمية
phonemics	phonématique	علم الوحدات الصوتية
phonemic stress	accent distinctif	-نبر(مميز) -تطويح مميز
phonemic structure	structure phonémique	-تركيب الوحدات الصوتية -بنية صوتية حرفية
phonemic substutution	substutution phonémique	استبدال حرفي
phonemization	phonémisation	تحول إلى حرف صوتي مساق حرفي دال
phonetic	phonétique	صوتي
phonetic alphabet	alphabet phonétique	ألفبائية صوتية
phonetic alternation	alternace phonétique	-تناوب صوتي -تعاقب صوتي
phonetic change	changement phonétique	تحول صوتي
phonetic complement phonetic indicator	indicateur phonétique ;indicateur (de prononciation)	دليل النطق (علامة في الكتابة تدل على النطق)
phonetic context	contexte phonétique	سياق صوتي
phonetic empathy	comportement perceptuel ( de l’auditeur)	ادراك استئناسي للحرف (من قبل المخاطب)
phonetician	phoéticien	عالم الأصوات (اللغوية)
phonetic modification	modification phonétique	تحول صوتي
phonetic notation	notation phonétique	كتابة صوتية
phonetic representation	représentation phonétique	تمثيل صوتي
phonetics	phonétique	الصوتيات
phonetic script	écriture phonétique	كتابة صوتية
phonetic sign	signe (symbole) phonétique	علامة صوتية (رمز)
phonetic soun change	changement phonétique	تحول صوتي
phonetic spelling	orthographe phonétique	تهجئة صوتية
phonetic symbols	symboles phonétiques	رموز صوتية
phonetic transcription	transcription phonétique	كتابة صوتية
phonetic variant	variante phonétique	بدل صوتي
phonetic writing	écriture phonétique	كتابة صوتية
phonic	phonique	صوتي
phonic group	groupe phonique	مجموعة صوتية متجانسة
phonic substance	substance phonique	مادة صوتية
phonogram	phonogramme	هجاء صوتي
phonography	phonographie ;sténographie	كتابة مختزلة
phonological analysis	analyse phonologique	تحليل صوتي (تحليل فونولوجي)
phonological change	changement phonologique	تحول صوتي
phonological components	composants phonologiques	عناصر صوتية مميزة
phonological item	item phonologique	وحدة صوتية
phonologist	phonologue	عالم الصوتيات الوظيفية
phonology	phonologie	الصوتيات الوظيفية
phonometrics	1-phonométrique 2-phonostylistique	1-الاحصائيات الوظيفية 2-علم الأسلوب الصوتي
phono-morphology ;morpho-phonology	phono-morphology morpho-phonologie	علم الأصوات التصريفي
phonostylistics	phonostylistique	علم الأسلوب الصوتي
phonotactics	phonotactique	دراسة تركيب الأصوات
phrasal compound	mot composé  (deux mot à sens différent)	مركب تعبيري تركيب مزجي
phrasal verb	syntagme verbal	تركيب فعلي
phrase	syngtame	-مجموعة -تركيب
phrase marker	arbre indicateur de syntagme ;indicateur syntagmatique	شجرة التراكيب
phrase structure	structure syntagmatique	البنية التركيبية  (السطحية أو الظاهرة)
phrase structure grammar	grammaire génératrice de structure syntagmatique	نحو تفريغي (للبنى التركيبية)
phrase structure rule	régle de structure syntagmatique	قاعدة البنية التركيبية
physical phonetics	phonétique physique	الصوتيات الفزيائية
physiological phonetics	phonétique physiologique	الصوتيات الفزيولوجية
pictogram	pictogramme	هجاء تصويري
pictography	pictographie	كتابة تصويرية
pidgin	pidgin	لغة هجينة
pitch	pitch ;hauteur	-طبقة الصوت -درجة الصوت
pitch accent	accent de hauteur	تنغيم
pitch functions	fonctions du pitch	وظائف طبقة الصوت
pitch levels	niveaux du pitch	مستويات طبقة الصوت
place of articulation	point d’articulation	مخرج
plain	1-bémolisé 2-simple ;non arrondi	1-غير مضموم  (من حيث التلفظ) 2-مخفوض (من حيث التحليل الصوتي الفزيائي)
planned language change	changement linguistique planifié	تكييف لغوي مخطط
pleonasm	pléonsame	1-لغو (إذا كان مفيدا) 2-حشو (إذا كان غير مفيد)
plereme	pléréme	-مشترك دلالي -بلريم
plosion	plosion	1-إطلاق (في مقابل الحبس) 2-تحريك (في مقابل التسكين) 3-انفجار(في نظر الغربيين)
pluperfectense	plus-que-parfait	صيغة المركب الثاني (في اللغة الأنجلزية)
plural	pluriel	الجمع
plurative	désinence de pluriel	علامة الجمع
plurilingualism	plurilinguisme	تعدد اللغات
plutivocal ;polysemic	plurivoque	متعدد المعاني
poetic licence	licence poétique	ضرورة شعرية
poetics	poétique	فن الشعر
poetry	poésie	شعر
point(position) of articulation	point d’articulation	مخرج
polite form	forme de politesse	صيغة التلطف
polygenesis	théorie polygénitique ;polygénisme	نظرية تعدد أصول اللغات
polyglot	polyglotte	المتعدد اللغات (المتكلم بأكثر من لغتين)
polylingual	plurilingue	متعدد اللغات
polysemy ;polysemia	polysémie	اشتراك لفظي
polysyllabic	polysyllabe	متعدد المقاطع
polysynthetic language	langue polysynthétique	لغة تركيبية
polysystemic	polysystémique	متعدد الأنظمة
polysystémic phonology	phonologie$ poly systémique	الصوتيات الوظيفية  متعددة الانظمة
polytonic language	langue à tons	لغة نغمية
pooh-pooh theory origin of speech	théorie pooh-pooh (origine de la parole)	نظرية الأصوات الانفعالية (في أصل اللغة)
popular etymology	étymologie populaire	-اشتقاق متوهم -تأصيل وهمي
portmanteau  morpheme	morphème portemanteau	دالة ممتزجة
portmanteau word	mot portemanteau	كلمة ممتزجة
posostional variant	variante contextuelle	بدل اضطراري
possessive adjective	adjectif possesif	ضمير الملك المتصل
possessive case	cas possessif	حالة الملكية
possessive prounoun	pronom possessif	ضمير الملك المنفصل
post-alveolar	postalvéolaire	-من أعلى النطع مما فوق النطع
post-article	postarticle	ما بعد أداة التعريف
post-dental	post-dental	-من أعلى الثنايا -مما فوق الثنايا
post-determiner	post-déterminant	ما بعد أداة التعريف
post-dorsal	post-dorsal	من أقصى اللسان
post-nominal modification	modification post-nominative	تخصيص ما بعد الاسم
post-palatal	postpalatal	-من أقصى الحنك -صفاقي
post-pharynx	post-pharynx	أقصى الحلق
postposition	postposition	أداة متأخرة
post-tonic	post-tonique	ما بعد المنبور
post-velar	postvélaire	ما فوق الصفاق
post-vocalic	postvocalique	ما بعد مصوت (كصفة يقال يقع بعد مصوت)
pragmatics	pragmatique	-دراسة استعمالية (دراسة كيفية استعمال الناطقين للغة في حالات الخطاب الملموسة) -براغماتية
pre-adjective	pré-adjectif	صفة مقدمة  (على الموصوف)
pre-article	préarticle	ما قبل أداة التعريف
preaspirate	préaspiré	ذو نفس مسبق
prebase	préfixe	-مسابقة -صدر
pre-co-ordinator	pré-coordinateur	-ما قبل العاطف -ما قبل الربط
predicate	prédica (attribut)	1-المسند(في النحو) 2-المحمول(في المنطق وفي النحو المتأثر بالمنطق)
predicate adjective	adjectif qualificatif	صفة في موضع المسند
predicate phrase	syntagme prédicatif	مجموعة المسند  (أو المحمول)
predication	prédication	إسناد
predicative construction	construction prédicative	تركيب إسنادي
prefix	préfixe	-سابقة -صدر
preliteracy	pre-alphabétisation	ما قبل تعليم الكتابة
prepalatal	prépalatal	شجري
prepostion	préposition	حرف جر
prepositional	prépositionnel	خاص بحرف الجر
prepositional  group/phrase	syntagme prépositionnel	مجموع الجار والمجرور
prepositional   object	objet(complement)  prépositionnel	مفعول مجرور (بحرف الجر)
prescreptive  grammar	grammaire prescriptive/ normative	نحو معياري
prescriptivism	prescreptivisme	المعيارية
present participle	participe présent	صيغة اسم الفاعل (وقد تدل على المصدر مثل الأنجلزية)
present tense	présent	صيغة الحال
presuposed	présupposé	لازم المعنى
presuposition	présupposition	دلالة لزوم
pretrite	prétérit	ماض
preterition	prétérition	تعريض
preterminal	préterminal	ما قبل الطرف
pretonic	prétonique	سابق للنبر الرئيسي
prevelar	prévélaire	-صفاقي -ما فوق الشجر
preverb	préverbe	-ما قبل الفعل -داخل على الفعل
prevocalic	prévocalique	ما قبل المصوت
primary analogy	analogie primaire	-قياس -حمل أصلي
primary articulation	articulation primaire	مركب أصلي
primary compound	composé primaire	مشتق أصلي (كلمة من مورفيمين مقيدين)
primary language	langue première	-اللغة الأم -اللغة الأصلية
primary phoneme	phonème primaire	حرف صوتي  أصلي
primary stress	accent principal/primaire	-نبر رئيسي -النبر الأقوى
primary vowels	voyelle cardinales/primaires	أصول المصوتات  الرئيسية
primary(prime) word	mot original/primaire	كلمة أصلية
primitive	primitif	أصلي
principal	mot principal (dans une apposition)	مبدل منه
principal clause	proposition principales	الجملة المحمول عليها
principal parts	partie principales	الأمثلة المحمول عليها
principal verb	verbe plein/principal	فعل تام
privative affix	affixe privatif	-زائدة للسلب -زائدة للنفي  (مثل الهمزة في "أعجم")
privative opposition	opposition privative	-تقابل بالنفي تقابل سالب
privilege of occurence	privilège d’apparition	-الموضع الأصلي -الموضع المخصص له
pro-adjective	proadjectif	بديل النعت
probality	probalité	احتمال
procedure	procédure	طريقة
process	processus	مجرى (العنصر) (منهج تحليلي)
proclisis	proclise	وصل الكلمة بما بعدها
proclitic	proclitique	موصول بما بعده
productive	productif	مقيس (يقاس عليه)
productive affix	affixe productif	زائدة مقيسة
producativity	productivité	مقيسية (صفة الذي يقيس عيله بكثرة)
proform	proforme	جنس
programmed  instruction	enseignement  programmé	تعليم مبرمج
programming	programmation	برمجة
progressive aspect	aspect progressif	صيغة الحال المتصلة
progressive assimilation	assimilation progressive	تقريب طردي
progressive dissimilation	dissimilation progressive	تبعيد طردي
progressive tense	temps progressif	زمن الحال المتصلة
prohibitive	prohobitif	النهي
projection rules	régles de projection	-قواعد الاسقاط -قواعد إدراج المعاني
pronominal	pronominal	ضميري (ما له حكم الضمير أو الأدوت المنفصلة)
pronominal adjective	adjectif(pronom) possessif/démonstratif	خالفة مخصصة (للملك أو الإشارة)
pronominalization	pronominalisation	تضمير (تحويل إلى ضمير)
pronoun	pronom	-ضمير -خالفة منفصلة (الخالفة أعم من الضمير)
proparoxytone	proparoxyton	مطوح الوسط (كلمة منبورة على المقطع الثالث من آخرها)
proper adjective	adjectif dérivé de nom propre	منسوب إلى علم
proper compoud	composé a flexion finale	-مركب تام -مركب مزجي
proper name/noun	nom propre	اسم العلم
pro-phrase	pro-syntagme	بديل تركيب
proportional analogy	analogie  proportionnelle	-تناسب -قياس تناسبي
proportional oppositions	oppositions proportionnelles	متقابلات متناسبة
prose	prose	نثر
prosodeme	prosodéme	وحدة نبرية
prosodic analysis	analyse prosodique ; aspect prosodique	تحليل النبر
prosodic features	traitsv prosodique ;  aspect prosodique	صفات نبرية
prosodic marks/signs	marques(symboles) prosodiques	علامات تطويحية
prosody	prosodie	1-مستوى التطويح 2-جملة الشرط
protasis	proposition  conditionnelle	تصدير صوتي
protheic  (prosthesis)	prothétique (son)	-صوت الوصل -حركة الوصل
protraction	protraction	مد الشفتين (عند النطق بالضم)
pro-verb	proverbe	بديل الفعل
provincialism	provincialisme	-تعبير لهجي لغة إقليمية
proximate	forme pronominale	-ضمير للقريب -خالفة للقريب (الخالفة أعم من الضمير
proximaty ;necuness	proximité	القرب
pseeudo-cleaving	pseudo-clivage	الإخبار بالذي
pseudo-lingua-franca	pseudo-sabir	شبه لغة (لغة مزيجي من عدة لغات)
pseudo-semantic-devlopement	développement  pseudosémantique	-تطور شبه دلالي -تطور شبه معنوي
pseudo-synonym	pseudo-synonyme	شبه مرادف
psychoacoustic	psychoacoustique	علم النفس الصوتي
psycholinguistics ;psycological linguistics	psycholinguistique ;linguistique psychologique	اللسانيات النفسية
psychological phonetics	phonétique auditive	دراسة الصوتيات السمعية
psychological subject	sujet psychologique	-المحدث عنه -المخبر عنه
psychomechanic	psychomécanique	النظرية النفسية الآلية (لصاحبها جوستاف غليوم)
plumonic air-stream	courant d’air plumonique	مجري الهواء الرئوي
plumonic cavity	cavité plumonique	تجويف الرئة
plumonic closure	fermeture(occlusion) plumonaire	إغلاق رئوي
pun	jeu de mots	-اتباع -ازدواج
punctuation	ponctuation	ترقيم
pure vowel	voyelle simple	مصوت بسيط
purism	purisme	-النقاوية (التمسك بنقاوة اللغة) -تفصح لغوي
		
		
		
		
		
		
		
		
		
		
		
		
		
quadriliteral	quadrilitéral	رباعي
qualifier	qualificatif	مخصص
qualifying conjunction	conjonction de coordination	حرف عطف
qualitative ablaut	ablaut qualificatif	تعاقب الحركات الكيفي (مقابل الكمي الذي يقع بتغيير المد أو بالحذف)
qualitatif accent	accent qualitatif	نبر كيفي
qualitative gradation	gradation qualitative	تعاقب الحركات الكيفي
quality	qualité vocalique	نوعية المصوت
quality features	traits de qualité	صفات كيفية
quantifaible noun	nom comptable	اسم جنس معدود (قابل للعد)
quantifier	quantificatif ;quantifier	-دليل للعدة -حاصر (لفظ منطقي)
quantitative ablaut	ablaut de quantité ; ablaut quantitatif	-تعاقب الحركات الكمي -تعاقب مدي
quantitative accent	accent quantitatif	نبر كمي تطويح مدي
quantitative gradation	gradation quatitative	تعاقب الحركات الكمي تعاقب مدي
quantitative linguistics	linguistique mathématique	اللسانيات الرياضية
quantity	quantité	-المد -طول الصوت
quantity mark	marque de quantité	علامة المد
quasi-auxilary	pseudo-auxilaire	شبه أداة فعلية
question	quéstion	-سؤال -استفهام
question mark	point d’intérrogation	علامة استفهام
questionnaire	questionnaire	-استبيان -مستنطق (للتحريات في جغرافية اللغة)
question transformation	transformation d’interrogation	تحويل إلى استفهام
question word	mot interrogatif	كلمة استفهام
quotation	citation	-نص منقول -اقتباس
quotation marks	guillemets	علامة التنصيص
		
		
		
		
		
		
		
		
		
		
		
		
		
		
		
		
		
		
radiating center	centre de rayonnement ;centre de diffusion	مركز إشعاع
radiation	rayonnement ;diffusion	إشعاع
radiation of synonyms	1-effet de rayonnement des synonyes 2-diffusion des synonyms	1-تأثير إشعاعي للمترادفات 2-انتشار المترادفات
radical	radical	1-أصل 2-حرف اصلي
radical flexion	flexion compléte	تصريف جذري
radical language	langue radicale	لغة عازلة
random variations	variations non-systématiques(érratiques)	1-تصاريف شاذة 2-تنوعات شاذة
rank	rang	رتبة
rank scale	échelle de valeurs	مقياس رتبي
rank shift	changement de rang	تحول الرتبة
real definition	définition réelle	تعريف حقيقي
ralization	réalisation	-تحصيل اللفظ -تحصيل المعنى
recategorization	recatégoration	تنقل (إلى جنس آخر) -تصيير
receipt	réception	استقبال الخطاب
receipt	reçu	-فصيح (لفظ) -مرضي
received pronunciation	prononciation modéle	-نطق جيد -نطق مأخوذ به
receiving	récepteur	المستقبل(المخاطب)
recessive accent	accent regressif/recessif	نبر تراجعي (نبر قوي على المقطع الأول للكلمة)
recessive stress	accent initial fort	نبر أولي قوي
reciprocal assimilation	assimilation réciproque	تقريب متبادل
reciprocal prounoun	pronom réciproque	-ضمير المشاركة ضمير متبادل
reciprocal verb	verbe réciproque	فعل المشاركة
reciprocity	réciprocité	-المشاركة -انعكاس
recomposition	récomposition	إعادة بناء الكلمة
reconstruction	reconstruction	إعادة تركيب لغوي (إلى أصله التاريخي)
rection	rection	العمل
recursiveness	recursivité	-إطالة -تثنية
redoubling	redoublement	تضعيف
reduced sentence	phrase réduite	جملة مختزلة
reduced vowel	voyelle réduite  (bréve)	1-مصوت مقصور (ضد الممدود) 2-مصوت مختلس (مختزل اختزالا كبيرا)
reduction	réduction	اختزال (اللفظ)
redundancy	redondance	زيادة مفيدة (وظيفية)  -حشو
reduplication	reduplication ; redoublement	-تضعيف -تكرار
reduplicative morpheme	morphéme redoublé	دالة مضعفة
reference	référence	-دلالة  (علاقة بين الكلمة  ومقصودها) -إحالة دلالية
reference theory of meaning	théorie référentielle du sens	نظرية الاحالة على المدلول عليه
referend (referent)	référent	المدلول عليه (عين المسمى)
referential function	fonction référentielle	الدلالة على المسمى
referential meaning	sens référentiel	المعنى الوضعي (معنى اللفظ الذي بدل عليه بالوضع)
referred speech	discours indirect	أسلوب غير محكي
reflex	réflexe (d’un étymon)	سليلة  (فرع تاريخي أو متفرع تارخيا)
reflexive pronoun	pronom réfléchi	ضمير الذات
reflexive verbe	verbe réfléchi	فعل المطاوعة
register	registre	مستوى التعبير
regressive assimilation	assimilation regressive	تقريب توقعي
regressive dissimilation	dissimilation régressive	تبعيد توقعي
regressive formation	recomposition	-اشتقاق بالحذف -اشتقاق معكوس
regrouping	regroupent	جمع
regular alternation	alternance réguliére	تعاقب مطرد
regular correspence	correspondance réguliére	-توافق منتظم تناسب مطرد
regularity	régularité	اطراد
regular sound change	changement phonétique régulier	تحول صوتي مطرد
regular verb	verbe régulier	فعل قياسي  (مطرد التصرف)
related language	langue apparentée	لغة قريبة
relational word	conjonction	أداة ربط
relative adverb	adverbe relatif	-اسم موصول قريني -ظرف صلة
relative clause	subordonnée relative	صلة الموصول
relative negation	négation relative	نفي مقيد
relative pitch	pitch relatif	طبقة صوت نسبية
relative pronoun	pronom relatif	اسم موصول
relativization	relativisation	الربط بالموصول
relator-axis-clause	proposition subordonnée (en tagmémique)	جملة محمولة (في التاكميمية)
relat axis phrase	syntagme prépositionnel  (en tagmémique)	تركيب إضافي
release	plosion	-إطلاق -تحريك
relevance	pertinence	الوظيفية التمييزية
relevant	pertinent	مميز (في مقابل العرضي أو العارض)
relic area	aire(région) conservatrice	منطقة لغوية محافظة
relic form	forme relique	صيغة أثرية
remote area	aire(région) isolée	-منطقة منعزلة -منطقة بعيدة
repertory	répertoire	ذخيرة
repetitive compound	composé à redoublement	مركب تكراري
rephonologization	rephonoligisation	إعادة التقابل الحرفي
replacement	remplacement	استبدال
replacive	substitutif	استبدالي
replacive morph	morphe-substitut ; morphe remplaçant	-دالة مثالية -صورة دالة
replica	reproduction	صورة منقولة
reported question	interrogation indirecte	استفهام تعليقي
reported speech	discours indirect	أسلوب غير محكي
representation	représentation	المقابل في اللفظ (أو الكتابة)
repesentation	représentation	وظيفة تمثيلية
representativity	représentativité (d’un corpus)	نموذجية (المدونة)
reshaping	reformulation	إعادة الصياغة
residual	phonéme résiduel	وحدة صوتية متبقية
residue (resisual) forms	formes résiduelles	صيغ متبقية
resonance	résonance	رنين
resonance chamber	1-chambre de résonance 2-vide résonateur	1-تجويف رنين 2-فراغ رنان
resonance curve	courbe de résonance	منحنى الرنين
resonant	résonateur	رنان
response	réponse	استجابة
restricted code	parler réduit (simplifié) ; langue réduite (simplifiée)	لغة مبسطة
restricted language	parler (langue) spécialisé	لغة التخصص
restricted stress	accent limité(régis)	-نبر مقيد -تطويح مقيد
restriction	restriction (de sens)	تخصيص (المعنى)
restrictive modifier	modificateur restrictif	-معدلة مقيدة -مخصص تقييدي
retained object	objet du passif	مفعول المبني للمجهول
retracted	vélarisé(son)	-مفخم (عند بعض اللغويين) -صفاقي (نسبة إلى صفاق الشجر)
retroflex	rétroflexe	تقعيسي(مخرج)
retroflexion	rétroflexion	تقعيس اللسان
retrogressive	rétrogressif ;rétrograde	-تراجعي -توقعي
retrogressive assimilation	assimilation rétrograde	تقريب توقعي
retrogressive dissimilation	dissimilation rétrograde	تبعيد توقعي
reverse spelling	orthographe rétrograde ;orthographe inverse	تهجئة معكوسة
reversible	réversible	يعكس
revival form	archaisme	مهجور
rewrite rule	régle de réécriture	قاعدة إعادة الكتابة (فب النحو التحويلي)
rheme	1-rhéme 2-commentaire 3-propos 4-prédicat	-المسند (في النحو) -المحمول(في النحو المتأثر بالمنطق)
rhetoric	rhétorique	-خطابة -علوم البلاغة
thotacism	rhotacisme	رأرأة
rhotacization	rhotacisation	عملية تحويل الصوت إلى راء
rhyme	rime	قافية
rhyme word	mot-rime	كلمة مقفاة
rhythm	rythme	إيقاع
rhythmic group	groupe rythmique	مجموعة إيقاعية
rising dihthong	diphtongue ascendante ; diphtongue montante	مزدوج صاعد
rising falling	montant__descendant (intonation)	-حادر/صاعد -متنازل/متصاعد
rising juncture	joncture (jointure) à intonation montante	وصل صاعد (علامة التنغيم الصاعد في الأواخر)
rolled consonant	consonne roulée	صامت مكرر
romance languages	langues romanes	اللغات الرومنية
romance linguistics	linguistique romane	اللسانيات الرومنية
root	racine	-جذر -أصل
root(tongue)	racine (langue)	العكدة(أقصى اللسان)
root-creation	création onomatoéique de racine	إنشاء على الحكاية الصوتية
root inflected languages	langue à racine fléchies	لغة متصرفة الجذور
root inflection	flexion des racines	تصريف الجذور
root isolating language	langue isolante	لغة عازلة
rounded vowel	voyelle arrondie	مصوت مضموم
rounding	arrondissement	-تدوين الشفتين -ضم الشفتين
rule of grammar	régle de grammaire	قاعدة نحوية
		
		
		
		
		
		
		
		
		
		
		
		
		
		
		
		
		
		
		
		
		
		
		
sandhi	sandhi	ساندهي (ظواهر تحدث بسبب الاتصال)
sandhi aleternats	alternants sandhi	بدائل نحتية (متعاقبات ساندهية)
sandhi form	forme sandhi	صيغة منحوتة (صيغة حاصلة بالساندهي)
saying	proverbe	مثل
scale and category  grammair	grammaire des niveaux et des catégories ;grammaire systématique	نظرية المستويات والأجناس (مدرسة هاليداي النحوية)
schema	schéma	رسم
scholasticism	scolastique	المدرسانية
school grammar	grammaire scolaire	قواعد النحو المدرسية
schwa ;shwa	schwa	شبهة  (حركة خفيفة محايدة)
science of language	science du langage	علم اللسان
scientific grammar	grammaire scientifique	نحو علمي
scriptural	scriptural	كتابي
secondary articulation	articulation secondaire	تقطيع ثانوي
secondary derivative	dérivatif secondaire ;racine augmentée d’un affixe	-مشتق ثانوي -الجذر المزيد
secondary features	traits secondaires	صفات ثانوية
secondary language	1-deuxiéme langue 2-langue complémentaire	-لغة ثانوية -لغة الثقافة
secondary phoneme	1-phonéme secondaire 2-phonéme prosodique	وحدة نبرية
secondary unit	unité secondaire ;unité dérivée	-وحدة ثانوية  -وحدة مشتقة
secondary word	mot composé (d’un thème plus un affixe	كلمة مركبة
second language	seconde langue	لغة ثانية
second order métalanguage	seconde langue	اصطلاح
second order language	métalangage	-وضع ثان  (في مقابل أصل اللغة والوضع  الأول)
second past perfect	passé antérieur	الماضي المنقطع  السابق
second perfect	plus que parfait	الماضي المنقطع الثاني
second person	deuxième personne	مخاطب
second possessive	pronom possessif	-ضمير الملك الثاني (في بعض اللغات) -ضمير الملك المنفصل
segment(of speech)	analyse segmentale	-جزء -قطعة (من الكلام)
segmental phonemes	analyse segmentale	تحليل تقطيعي
segmental phonemics	phonématique segmentale	-علم الحروف المقطعة -صوتيات وظيفية تقطيعية
segmental phonology	phonologie segmentale	علم الحروف المقطعة
segmentation	segmentation	تقطيع (تجزئة الكلام)
segmentator	segmentateur ;segmenteur	مقطع
selection restriction	restriction de selection	تقييد الاختيار
self-regulation	auto-régulation	انضباط ذاتي
semanteme	sémantéme	دال الماهية 1-معنى إفرادي 2-معنى المفردة 3-دالة إفرادية (عند قدماء العلماء الغربيين)
semantic amalgam	amalgame sémantique	مزج معنوي
semantic analyse	analyse sémantique	تحليل معنوي
semantic change	changement sémantique	تحول معنوي
semantic component	composant (e) semantic	عنصر معنوي
semantic contagion	contagion sémantique	عدوى معنوية
semantic differentielle	analyse différentielle	تحليل تفاضلي  للمعاني
semantic distinguisher	marqueur sémantique/distinctif	مميز معنوي
semantic extension	extension sémantique	اتساع المعنى
semantic feature	trait semantic	صفة مميزة للمعنى
semantic filed	champ sémantique	-مجال معنوي -حقل دلالي
semantic filed theory	théorie des champs sémantique	-نظرية الحقول الدلالية -نظرية المجالات المعنوية
semantic group	groupe sémantique	مجموعة معنوية
semantic indicator	indicateur sémantique	مميز معنوي
semantic information	information sémantique	مفاد
semantic marker	marqueur sémantique	مميز معنوي
semantic pair	paire sémantique	زوج معنوي
semantic potentialities	potentialitités sémantique	احتمالات معنوية
semantic preperty	propriété (caractéristique) sémantique	عنصر معنوي
semantic range	portée sémantique	مجموع السياقات الممكنة (مجموع المعاني)
semantic rejuvination	renouvellement sémantique ;régénérescence	إحياء معنى
semantics	sémantique	علم المعاني
semantic shift	mutation (changement ) sémantique	تحول معنوي
semantic structure	structure sémantique	بنية معنوية
semantic triangle	triangle sémantique	المثلث الدلالي للمعنى
semantic value	valeur sémantique	المدلول المعنوي
semasiology	sémasiologie	علم المعاني الللفظي (في مقابل دراسة الأدلة انطلاقا من المعاني)
seme	séme	-وحدة معنوية -معنى مفرد
seme	séméme	-وحدة دلالية -معنى مركب
sememic stratum niveau	niveau sémique/sémémique	-مستوى دلالي -مستوى افراد المعاني
semi-auxilary	semi-auxiliaires	النواسخ
semi-consonant	semi-consonne	-شبه صامت -حرف لين
semi-contoid	semi-contoide	شبه صامت
semiology ;semiotics	sémiologie ;sémiotique	1-علم الأدلة 2-علم السمياء (عند سوسور) 3-علم الدلالة اللفظية (عند من يميز الدلالتين دلالة اللفظ ودلالة المعنى)
semiotic system	système sémiotique	-نظام دلائلي -نظام رمزي
semi-syntactic compound	composé semi  syntactique	-مركب شبه نظمي -شبه مركب
semi-vowel	semi-voyelle	-شبه مصوت -حرف لين
sense	sens	معنى
sense relations	relations sémantiques	علاقات المعنى
sensory aphasia	aphasie sensorielle	حبسة حسية
sentence	phrase	-جملة -كلام
sentence adverbial	adverbe de phrase	-تعبيرة ظرفية  -مخصص للدواخل على  الجملة
sentence compound	phrase complexe coordonée	جملة مركبة
sentence connector	connecteur de phrases	رابطة الجمل
sentence fragment	fragment de phrase	جزء جملة
sentence modifier	adverbe modificateur de phrase	مخصص للدواخل على الجملة
sentence parts	catégories syntactiques	-أجزاء الجملة -مقومات الجملة
sentence pattern	-modèle de la phrase -pattern de la phrase	-نمط الجملة -مثال جملة
sentence rythm	rythme de la phrase	إيقاع الجملة
sentence stress	accent de la phrase ; accent sepitactique	-نبر الجملة -تطويح كلامي
sentence word	mot-phrase	-مفردة مفيدة -جملة مفردة
separable prefix	préfixe séparable	سابقة قابلة  للفصل
separable suffix	suffixe séparable	لاحقة قابلة  للفصل
sequence	séquence	-تسلسل -مساق
sequence of tenses	concordance de temps	مطابقة صيغ الأفعال (في الجملة المركبة)
sequence sebtence	phrase-séquence	جملة السياق
sequencing	classement de séquences	-تنظيم تسلسلي -تدريج
series	séries	-سلسلة -ترتيب(بالنسبة للمخارج)
sharp	diésé	-مستقل المخرج (من حيث النطق) -مخفوض (من حيث التحليل الفزيائي)
shifter	shifter	-متحولة المبهم  (في النحو العربي) -متنقلة (في مقابل "اللازم")
shifting stress	accent mobile	-نبر متنقل -تطويح متنقل
shift of accent	mutation de l’accent	تحول النبر
shift of meaning	changement de sens ;mutation sémantique	تحول معنوي
shift signs	marques secondaires (voyelle)	علامات ثانوية  (للمصوتات)
shortening	abrégement	-قصر -اختلاس (فيما يخص الحركات)
sibilant	sifflant	-صفيري -أصوات الصفير
sign	signe	دليل
signal	signal	إشارة
signifiant ;significans ; significant ;signifier	signifiant	دال
significance ;signification	significance ;	-الدلالة -المعنى المدلول
significant segment	segement significant	كلمة  (في النحو العربي ،المذهب الخليلي)
significatum ;signifié ;signified	signifié	مدلول
sign language	langage gestuel	لغة الإيماء
simile	métaphore	استعارة
simple past	passé simple	1-الماضي المجرد (في الأنجلزية) 2-الماضي البسيط(في الفرنسية)
simple perfect	parfait	-الماضي المركب الأول -الماضي المركب المبهم
simple predicat	prédicat simple	مسند بسيط
simple sentence	phrase simple	جملة بسيطة
simple stem	mot simple ;mot monomorphémique ; morphéme-racine	دالة جذرية كلمة ذات (أصل منفرد)
simple stop	occlusive simple	-حرف شديد بسيط -حرف حبسي بسيط
simple tense	temps simple	صيغة بسيطة للفعل
simple transformation	transformation simple	تحويل بسيط
simple vowel	voyelle simple	مصوت بسيط
simple-wave-form	onde sonore simple	موجة صوتية بسيطة
simulation	simulation	التمثيل
simultaneity axis	axe des simultanéités	محور المتزامنات
simultaneous interpreting	traduction simultanée	ترجمة فورية
single-bar juncture	jonction à barre unique	علامة التنغيم المستوى
sing-song theory	téorie du chantement	نظرية الترنم  (في أصل اللغة)
singular	singulier	مفردة
sigularity	singularité	صفة الافراد
singular transformation	transformation singuliére	تحويل فردي
singulative	morphéme du singulier	علامة المفرد
sinusoidal wave form	onde sonore sinusoïdale	موجة صوتية  جيبية
sister language	langue-soeur	لغة شقيقة
situation	situation ;contexte siruationnel	الحال  (أو حال الخطاب أو حال الحديث)
situational meaning	sens situationnel	-دلالة الحال -المعنى الحالي
slack vowel	voyelle relachée ;voyelle lâche	مصوت رخو
slang	argot	-لهجة سوقية -لهجة مهنية
slender consonant	consonnz d’avant	صامت من مقدم الفم
slender vowel	voyelle d’avant	مصوت من مقدم الفم
slit fricative	fricative non-stridente	-احتكاكي غير صفيري -رخو انسلالي
slot	contexte d’occurence	-حيز وظيفي (في الجملة في المدرسة التاكميمية)
sociolinguistics	sociolinguistique	اللسانيات الاجتماعية
soft consonant (palatalized)	consonne mouillée	صامت مشجر
softening	mouillure	تشجير
soft palate	palais mou	-صفاق الشجر -سقف الحلق
solecism	solécisme	لحن (خروج عن العرف اللغوي) خطأ نحوي في الفرنسية واللغات الرومانية)
solid compound	composé primaire ;composé de base	مركب أصلي
soliloquy	solilogue	خطاب النفس
sonagraph	sonagraphe	مطياف
sonant	sonant	حرف أذلق
sonagram	sonagramme	طيفية... (رسم الصوت الطيفي)
sonometer	sonométre	صائت
sonority	sonorité	جهارة
sonority feature	trait de sonorité	صفة الجهر
sonorization	sonorisation	جهر (إجهار)
sotto voce	mediane neutre	من وسط الفهم
sound	son	صوت
sound change	changement phonétique	تحول صوتي
sound change by allophones	changement phonilogique	تحول صوتي
sound change by phonemes	changement phonologique	تحول الحروف
sound echoism	onomatopée	حكاية صوت
sound symbolism	symbolisme phonétique	رمزية صوتية
sound system	systéme phonologique	نظام صوتي
sound wave	onde sonore	موجة صوتية
source features	traits primaires ;trait de base	صفات أساسية
source language	langue-source	لغة الأصل
source sentence	phrase-source	جملة الأصل
speaking ;speech act	acte de la parole	كلام (كمصدر)
specialization of meaning	sens spécialisé ;sens restreint	تخصيص المعنى
specialized meaning	sens spécialisé ;sens restreint	معنى خاص
special language	langue spécialisée	-لغة خاصة -لغة تخصص
spectral analysis	analyse spectrale	تحليل طيفي  (في الأصوات)
spectrogram	spectrogramme	صورة طيفية
spectrpgraph	spectrographe	مطياف
spectrum	spectre	طيف صوتي (موجات الصوت)
speech	parole	كلام
speech community	caummunautéc linguistique	مجتمع كلامي (الناطقون بلغة ما)
speech defect/disorder	troubles de la parole	عيوب الكلام (أمراض الكلام)
speech impediment	empêchement de la langue	عوائق الكلام
speech improvement	amélioration de la diction	تحسين طريقة النطق (تجويد الأداء)
speech lapse	lapsus linguae	زلة لسان
speech organs	organes de la parole	أعضاء النطق
speech pathology	pathologie de la parole	علم أمراض الكلام
speech perception	-perception de la parole -discernement phonétique	إدراك الكلام
speech production	production de la parole	إخراج كلام
speech segment	segment de la parole	مقتطع كلامي
speech sound	son du langage	-صوت الكلام -صوت لغوي
speech synthesis	synthése de la parole	تركيب اصطناعي للكلام
speech synthethetizer	synthétiseur	-مركب -مؤلف
speech therapy	thérapeutique de la parole	علاج الكلام
spelling	orthographe	-تهجئة -قواعد الاملاء
spelling pronunciation	éppellation phonétique	نص هجائي
spirant	spirant (consonne)	حرف رخو
split infinitive	infinitif séparé de sa préposition régissante	مصدر فعل عار
spoken chain	chaine parlée	مدرج الكلام
spoken language	langage parlé ;langue parlée	لغة التخاطب
spontaneous sound	changement phonétique spontané	تحول صوتي غير مسبب
spoonerism	contrepéterie	تصحيف بالقلب
sporadic alternation	alternance sporadique	تعاقب غير مطرد
sporadic change	changement sporadique	تحول غير مطرد
spread vowel	voyelle étirée	مصوت مكسور (بحر الشفتين)
stammer	bégaiement	-تلعثم -تمتمة
standard dialect	dialecte standard	لهجة نموذجية
standardization	satandardisation	توحيد لغوي
satandard dialect	dialecte standard	لغة نموذجية
starred form	forme e-grammaticale	صيغة غير سليمة نحويا
state of language	état de la langue	حالة اللغة
static consonant	consonne constante	صامت ثابت
static grammar	grammaire statique	النحو الآني
static linguistics	linguistique statique ;linguistique sunchronique	اللسانيات الآنية
statistical linguistics	linguistique statistique ;linguistique quantitative	اللسانيات الرياضية
status	statut (social)	وضع اجتماعي
status label	indication d’usage	علامة الاستعمال
status verbe	verbe non-progressif ;verbe à l’accompli	فعل منقطع
stem	__théme d’un mot __radical d’un mot	مبني الكلمة (كلمة مجردة من لواحق التصريف أو الإعراب)
stem compound	théme composé	مبني مركب
stimulus	stimulus	-مثير -منبه
stochastic	stochastique	احتمالي
stop	stop	حرف شديد (انفجاري في النظرة الأروبية)
stratificational grammar	grammaire stratificationnelle	نحو طبقي (لعناصر اللغة)
stratification of language	stratification de la langue	تصنيف طبقي للغة
startum	strate	طبقة
stress	accent ;stress	-نبر -تطويح
stress accent	accent d’insistance	تطويح إلحاحي
stress functions	fonctions accentuelles	وظائف النبر
stress group	groupe accentuel ;unité accentuelle	مجموعة منبورة
stress mark	marque de l’accent	علامة النبر
stress phonemes	phonèmes accentuels ;phonème prosodiques	وحدات النبر
strident	strident	صار (في مقابل رخيم)
string	suite ;séquence	-مساق -مدرج قول
string analysis	string analysis	تحليل تسلسلي
stroboscope	stroboscope	مرداد
strong negation	négation forte	-جحود -إنكار
strong verb	verbe fort ; verbe à ablaut	فعل متعاقب (في الجرمانية)
structural allophonic change	changement allophonique structurel	تحول بنوي للمخارج
structural description	description de structure ; description structurelle	وصف بنوي
structural gap	case vide	-فجوة بنوية -خانة فارغة
structuralism	structuralisme	بنوية
structuralist(ic) linguistics	linguistique structurale	اللسانيات البنوية
structural marker	indicateur de structure ;indicateur structurel	-دليل البناء -علامة البنية
structural meaning	sens structurel	المعنى البنوي
structural semantics	sémantique structurale	علم المعنى البنوي
structural (structure)  word	mot fonctionnel	أداة وظيفية
structure	structure	-بناء -بنية
structure drills	exercices structuraux	تمارين بنوية
structured string	suite(séquence) structurée	ذات بنية
strump word	mot abrégé	كملة مختزلة
stutter(to)	bégayer	-فأفأ -تمتم
style	style	أسلوب
stylistics	stylistique	علم الأسلوب
stylistuc variants	variantes stylistiques/expressives	وجوه التعبير
stylostatistics	stylométrie ;stylostatisque	دراسة الأسلوب الاحصائي
subcategorization	sous-catégorie	-تصنيف تفريعي -تفصيل
sub-category	sous-catégorie	فصل
sub-clause	proposition subordonnée	جملة محمولة
subjacent	sous-jacent	مقدر
subject	sujet	1-مسند إليه (في النحو) 2-الموضوع (في المنطق والنحو المتأثر بالمنطق) 3-الفاعل أو المبتدأ في العربية
subject complement	prédicat nominatif ;prédicat nominal	خبر اسمي
subjective case	cas sujet ;cas nominatif	حالة المسند إليه
subjective pronoun	pronom sujet	ضمير فاعل
subjunction mood	mode subjonctif	صيغة الغاية
sub-minimal pairs	semi-paires minimales	شبه أزواج
subordinate clause	proposition subordonnée	جملة محمولة
subordinate word	mot modificateur	مخصص مفيد
subordinating conjunction subordinator	conjonction de subordination	-رابط حمل -أداة ربط اتباعي
subordination	subordination	حمل جملة
subordinative construction	construction subordonnée	تركيب حملي
subphonemic	allophone	-بدل صوتي -مخرج
subphonemic variant (allophone)	variante allophonique	-بدل صوتي متغير -مخرج متغير
suberelationship	sous-relation	علاقة فرعية (غير مباشرة بين اللغات)
substance	substance	-مادة (مضمون البنية  مثلا في مقابل الصورة) -جوهر (الذات)
sub-standard	non-standard ;inférieur	-دون النموذجي -دون الفصيح
substantival adjunct	adjoint au substantif	مخصص الاسم
substantive	substantif	اسم
substantive universals	universaux de substance	كليات جوهرية
substitute	substitut	بديل(كلمة)
substitute language	langue superalocale ;langue véhicuaire	لغة بديلة (غير وطنية)
substitution class	classe substitutive	-صنف بديل -جنس بديل
substitution drill	exercice de substitution	تمرين التبديل
substitution frame	cadre de substitution	قياس
substrat ;substratum	substrat	لغة المنشأ (اللغة الأولى المؤثرة)
successiveness axis	axe des successivités	محور المتعاقبات
suction stop	occlusive à succion	-انفجاري امتصاصي -انقاضي
suffix	suffixe	لاحقة
suffixing language	langue suffixante	لغة اللواحق
superadded	postiche	مستعار
superficial structure	structure de surface	بنية سطحية  -ظاهر اللفظ
superfix	courbe accentuelle ;trait prosodique	مميز تطويحي
superior comparaison	comparaison de supériorité	اسم التفضيل المعرف
superlative degree	degré de superlatif	درجة التفضيل
superordinate	superordonné	الجنس القريب  (تحته الأنواع والأفراد)
superstratum	superstrat	اللغة الطارئة
suppletion	suppléance	تعويض
suppletive	supplétif	-تعويضي (في جدول التصريف) -عوض
support vowel	voyelle de support ; voyelle épenthétique	مصوت مزيد
superadental	superadental	ما فوق الثنايا
supraglottal cavity	cavité supraglottale	التجاويف العليا
supraglottal cavity	cavité supraglottale	تسريب في التجاويف العليا
supraglottal friction	friction supraglottale	صفة تطويحية
suprasegmental feature	trait suprasegmental	-هجاء فوق الحرف -علامة تطويحية
uprasegmental phoneme	phonème uprasegmental	-وحدة صوتية فوق الحرف وحدة تطويحية
surd	sourd ;non voisé	مهموس
surface grammar	grammaire superficielle	نحو سطحي (يتناول ظاهر اللفظ)
sustainjoned juncture	joncture soutenue/maintenue	وصل مستو
svarabhakti	svarabhakti	صويت
switching	changement de code langue	تحويل الوضع
syllabary	syllabaire	نظام الكتابة المقطعية
syllabic	1-syllabique 2-syllabéme	مقطعي
syllabication	syllabation	تحليل مقطعي
syllabic consonant	consonne syllabique	صامت مقطعي
syllabic contoid	contoid syllanique	صامت مقطعي
syllabic dissimilation	dissimilation syllabique	تبعيد مقطعي
syllabic pattern	système (pattern) syllabique	نمط مقطعي
syllabic peak	sommet syllabique	قمة مقطعية
syllabic (syllable) sign	signe (marque) syllabique	علامة مقطعية
syllabic (syllable) writing	écriture syllabique	كتابة مقطعية
syllable	syllabe	مقطع صوتي
syllable nucleus	noyau de syllabe	نواة المقطع
syllabogram	marque syllabique	علامة مقطعية
syllabography	écriture syllabique	كتابة مقطعية
symbol	symbole	رمز
symbolic sign	signe symbolique	دليل رمزي
symbolism	symbolism	الرمزية
symmetrical patterning	systéme (pattern) symétrique	تناظر المثل
symmetry	symétrie	تناظر
synaesthesia	symbolisme phonique	رمزية صوتية
synaloepha	synaléphe	إدغام حذفي
synapsy	synapsie	التعدد (تعدد الدوال في التسمية الواحدة)
synchronic	synchronique	-آني -قراري
synchronic change	changement synchronique	تحول زمني
synchronic grammar	grammaire synchronique	النحو الآني
synchronic linguistics	linguistique synchronique	اللسانيات الآنية
synchronic phonemics	étude phonématique synchronique	دراسة آنية للنظام الصوتي
synchrony	synchronie	الوضع الآني
syncope	suncope	-سقوط -زوال
syncresis ;syncretism	syncrétisme	انصهار
syncretic form	forme syncrétique	صيغة منصهرة
syndesis	syndése	-ربط العبارات  -وصل (في مقابل الفصل)
syndeton	construction syndétique	تركيب ربطي
synecodche	synécdoque	مجاز مرسل
syneresis	synérése	إدغام مدي
synesis	syllepse	لمح الصفة
synonym	synonyme	-مرادف -مترادف
synonymic attraction	attraction synonymique	جاذبية الترادف
synonymy	synonymie	ترادف
syntactic	syntaxique ;syntactique	-نظمي(خاص بنظم الكلام) -تركيبي(في مقابل الإفرادي)
syntactic category	catégorie syntaxique/syntactique	-فصيلة نظمية -جنس تركيبي
syntactic change	changement syntaxique/syntactique	تحول تركيبي
syntactic component	composant syntaxique	عنصر تركيبي
syntactic compound	mot composé syntaxique	مركب نظمي
syntactic construction	construction syntaxique	بناء تركيبي
syntactic doublets	doublets syntaxique	رسيلة تركيبية (بدل تركيبي سياقي)
syntactic group	suite(groupe) syntaxique	مجموعة تركيبية
syntactic order	ordre syntaxique	ترتيب الكلام
syntactic pattern	pattern syntaxique	مثال تركيبي
syntactic phonology	phonologie syntaxique	الصوتيات الوظيفية التركيبية
syntactics	1-syntaxe  2-étude des relations entre symboles (sémiotique)	دراسة الانتظام  التركيبي
syntagm	syntagme	-بناء -تركيب
syntagma	syntagme complexe/ élargi	تركيب مزيد
syntagmatic sound change	changement phonétique syntagmatique	تحول صوتي تركيبي
syntagmeme	syntagméme	وحدة بنائية
syntax	syntaxe	1-مستوى التراكيب 2-دراسة التراكيب
synthesis	synthése	تركيب (عكس تحليل)
synthetic compound	mot composé synthétique	مركب مزجي (محتو على صيغة مقيدة أو أكثر)
synthetic	__index synthétique __indice de synthése	دليل التركيب
synthetic language	langue synthétique	لغة تركيبية
system	système	نظام
systematic phonemic representation	représentation phonémique  systématique	تمثيل حرفي منظم
systematic phonetic representation	représentation phonétique systématique	تمثيل صوتي منظم
systematic phonological representation	représentation phonologique systématique	تمثيل صوتي وظيفي منظم
systemic grammar	grammaire systématique	نحو نظامي (في نظرية هاليداي)
system-structure  grammar	grammaire  systémique	نحو نظامي
		
		
		
		
		
		
		
		
		
		
		
taboo	tabou	محظور
tach ;short hand	tachygraphie	استعمال الكتابة المختصرة
tactics	tactique	دراسة الانتظام الصوتي (أو الصرفي أو التركيبي)
tagma	tagma	تاكمة(عضو تاكميم)
tagmeme	tagméme	تاكميم(علاقة بين الوظيفية النحوية وما يشغلها)
tagmemic analysis	analyse tagmémique	تحليل تاكممي
tagmemics	théorie tagmémique ;tagmémique	التاكميمية
tag question	interrogation de confirmation	الاستثبات (في اللغة الانجلزية)
tamber(tambre)	timbre	جرس
tape recorder	magnétophone	مسجلة
tapped (flapped) R	R battu	راء ذات قرعة (غير مكررة)
traget language	langue-cible	لغة هدف اللغة المنقول إليها)
ta-ta theory	théorie ta-ta  (origine de langage)	نظرية تاتائية (تقليد الحركات الجسمانية)
tautologie	tautologie ;pléonsame	1-حشو 2-تحصيل حاصل (في التعبير)
taxeme	taxéme	وحدة تركيبية
taxonomic linguistics	linguistique taxonomique	اللسانيات التصنيفية
taxonomic phonemics	phonémique taxonomique	دراسة تصنيف الوحدات الصوتية
technical translation	traduction automatique	ترجمة آلية
teeth ridge	alvéoles	نطع
telescoped word	mot téléscopé	كلمة ممزوجة
tempo	tempo	سرعة النطق
temporal clause	subordonée de temps	ظرفية زمانية (جملة محمولة)
tense	temps	زمن
tense lax	tendu lâche	متوتر مسترخ
tense vowel	voyelle tendue	مصوت متوتر
term	terme	-مفردة -مصطلح (في اللسانيات الرياضية:ألفاظ أو أوضاع أو عبارات)
terminal contour	contour final (intonation)	منحنى تنغيم الأواخر
terminal juncture	jointure finale ; joncture finale	وصل الآخر
terminal stress	accent de fin de mot ; accent dans un oxyton	تطويح الآخر
terminal staring	suite terminale	-سلسلة أخيرة -سلسلة نهائية (في النحو التحويلي)
terminology	terminologie	-المصطلحية -علم المصطلحات
teritary stress	accent teritaire	نبرة ثالثة (تلي النبرة الثانوية)
tessitura (music)	étendue du pitch ; tessiture	سلم أنغام
thematic inflexion	inflexion(flexion) thématique	تصريف المبنى
thrmatic morpheme	morphéme thématique	زوائد على المبنى
theme	théme	1-المبنى (الجذر مع بعض الزوائد أو الصيغة) 2-المسند إليه المسند والمسند إليه
theoretical linguistics	linguistique théorique	اللسانيات النظرية
theory of meaning	théorie du sens	نظرية المعنى
theraapeutic change	changement thérapeutique	تحول ترميمي
thesaurus	thesaurus ;trésor (de langue)	ذخيرة لغوية  (مكنز)
thrid person	troisieme	غائب (شخص ثالث)
third person imperative	-subjonctif -mode impératif à la troisième personne	-صيغة أمرية -أمر الغائب
threshold of hearing	seuil auditif	حد السمع الأعلى
threshold of pain	seuil de la peine de l’audition	حد الألم
		علامة مميزة (في الكتابة)
tilde	tilde	جرس
timeless	temporal	خارج عن الزمن
tmesis	tmése	فصل (كلمة مركبة)
tonality features	traits de tonalité	صفات تنغيمية
tone	ton	نغمة
tone colour	timbre	جرس
tone language	langue à tons	لغة نغمية
toneme	tonéme	وحدة نغمية
tone of voice	ton de la voix	نغمة الصوت (المميزة للفرد)
tonetics	étude des tons	دراسة التنغيم اللغوي (نظام دراسة التنغيم في الكلام)
tongue	1-langue (organe) 2-langue	1-لسان (عضو النطق) 2-لغة
tongue height	évatation de la langue (organe)	ارتفاع اللسان
tonic	tonique	نغمي
tonic accent	accent tonique	تطويح نغمي
tonic syllabe	syllabe tonique	مقطع منبور
topic	topique	-موضوع  -المحدث عنه
topicalization	topicalisation	-التحديث(جعل الشيء محدث عنه) -الابتداء(في النحو العربي)
topology	topologie	دراسة مواقع الكلام
toponomasiology ; toponomastics ; toponomatology toponymy	toponymie ; toponosmatique	دراسة أسماء الأماكن
toponym	toponyme	اسم مكان
total assimilation	assimilation compléte ;assimilation totale	تقريب تام
total dissimilation	dissimilation compléte	تبعيد تام
trachea	trachée	قصبة هوائية
transcription	transcription	نسخ صوتي
transfer	interférence	تداخل
transfered meaning	transfert de sens	مجاز (كما في الاستعمال المجازي)
transform	structre transformée ; structure dérivée	تركيب محول
transformation	transformation	تحويل
transformational generative grammar	grammaire transformationnelle et générative	نحو تحويلي توليدي
transformational  rule	règle  transformationnelle	قاعدة تحويلية
transitional (transitory) sound	glide ;son transitoire	صوت انتقالي
transition area	aire de transition	منطقة وسطى
transitive verb	verbe transitif	فعل متعد
transitivity	transitivité	تعدية
traduction	traduction	ترجمة
translative	translatif	انتقالي
traductor	traducteur/interpréte	مترجم
transliteration	translitération	نقل كتابي  (كما في الكتابة العربية بحروف لاتنية)
transmission	transmission	إرسال
transmutation	transposition	تحول وظيفي
transparency	transparence	شفافية
transposition	transposition	-قلب مكاني -نقل مكاني
tree diagram	arbre syntaxique	رسم مشجر
triadic theory of meaning	sens triadique	النظرية الثلاثية للمعنى
triformantic	triformantique	مثلث البواني
triliteral root	racine trilitére	جذر ثلاثي
trill	consonne roulée	صامت مكرر
trilled R	R roulée	راء مكررة
triphthong	triphtongue	مصوت مثلث
trisyllabic	trisyllabique	ثلاثي المقطع
truncation	troncation	ترخيم
trope	trope	صورة بيانية
type and token	type prononcé	المقول وجنسه
typological  classification	classification  typologique	تصنيف نوعي
typologie	typologie	التصنيفية
		
		
		
		
		
		
		
		
		
		
ultimate constituents	constituants terminaux	مكونات نهائية
ultra-violet oscillograph	oscillograph  ultra-violet	مهزاز فوق  بنفسجي
umlaut	umlaut	إمالة
unacceptable	innacceptable	غير مستحسن
unaspirated stop	occlusif non-aspiré	-حبسي -غير نفسي
unbounded noun	-nom collectif -nom massif/massique	اسم جنس جمعي
unchecked	non-fermé non-bloqué	-غير مقيد -غير مسدود
unconditional sound change	changement phonétique non-conditionné	تحول صوتي غير مسبب
uncountable noun	nom non-comptable	اسم غير معدود
under-differentiation	manque de différnciation	تمييز ناقص (كالتفريق الناقص بين القاف  والكاف عند العرب)
underlying structure	structure sous-jacente	-بنية باطنية -بنية مقدرة
understood	sous-entendu	-مقدر -مضمر
ungrammatical	non-grammatical ; agrammatical	غير نحوي
unilateral consonant	consonne unilatérale	صامت من جانب واحد
unilingual	unilingue ;monomingue	أحادي اللغة
union language	langue d’union	لغة الوحدة
union noun	nom comptable	اسم معدود (قابل للافراد والجمع)
unipersonal verbs	verbes unipersonnels	أفعال جامدة
unique constituent	constituant unique	مكون فريد
unique morpheme	morphéme unique	عنصر دال فريد
unit	unité	وحدة
unit noun	nom comptable	اسم معدود
universal grammar	grammaire universelle	النحو العام
universal language	langue universelle	لغة عالمية
universals of language	universaux du langage	كليات لغوية
universe of discourse	univers du discours	قرائن الحديث
universe of statements	univers des énoncés	السماع
unmarked member	membre non-marqué	عضو بلا علامة (جزء أو فرد غير ذي علامة)
unproductive	non-productif	غير مقيس
unrounded	non-aronndi	غير مضموم
unrounding	1-non-arrondissement 2-délabialisation	1-عدم ضم الشفتين 2-إزالة الضم
unstable	instable	-معتل -غير مستقر
unstressed	non-accentué	غير منبور
unvoiced	non-voisé	مهموس
unvoicing	non-voisement ; assourdissement	إهماس
upward comparaison	comparaison de superiorité	تفضيل التفوق
usage	usage	-استعمال -عرف لغوي
usage label	appelation lexicogrphique	تسمية الاستعمال
utternance	énoncé ;propos	-كلام -حديث
uvula	luette	لهاة
uvular	uvulaire	لهوي
		
		
		
		
		
		
		
		
		
		
		
		
		
		
		
		
		
		
		
		
vague	vague	مبهم
value judgement	jugement de valeur	حكم معياري
variable word	mot variable	كلمة متصرفة
vriant	varinte	بدل 1-لغة (في مستوى الاختلاف اللهجي) 2-لثغة (خاص بالنطق الفردي)
variation	variation	تصرف
variety in language	variété linguistique	تنوع اللغة
velar	vélaire	-صفاقي -مستعل
velaric (velic) closure	occlusion vélaire	انسداد الصفاق
velarization	vélarisation	-استعلاء -تفخيم
velarized	vélarisé	مفخم
velum	voile du palais, palais mou	-صفاق الشجر -أقصى الحنك
verb	verbe	فعل
verbal adjective	adjectif verbal	صفة فعلية
verbal aspect	aspect du verbe	كيفية حدوث الحدث
verbal group	groupe verbal	مجموعة فعلية
verbalization	1-verbalisation rendre verbal	1-تعبير (بالكلام) 2-تحويل الكلمة إلى "فعل"
verbal noun	nom verbal	مصدر
verbal phrase	syntagme verbal	مجموعة فعلية
verbal skill	optitude orale	مهارة لغوية (كلامية)
verb cluster	groupe verbal ; syntagme verbal	مجموعة فعلية
verbid	forme verbale non conjuguée	صيغة فعلية غير مصرفة
vernacular	langue non-standard ; langue populaire	لغة دارجة (عاصية)
verner’s law	loi de verner	قانون "فرنر" (خاص بتطوير بعض أصوات اللغات الهند-الأروبية
verse	vers	-شعر بيت شعر
vetative	hortatif	الناهي
vibrant	vibrant	-ترعيدي(أو ارتعادي) -مكرر (خاص بالراء)
vibration	vibration	1-اهتزاز 2-ارتعاد الراء
vibratory feedback	feedback vibratoire	ارتجاع اهتزازي
video-recorder	mangétoscope	-مغناط صوري (أو بصارة)
visible speech	parole visible	كلام مرئي
vocabulary	vocabulaire	مفردات اللغة
vocabulary change	changement sémantique	تحول إفرادي
vocabulary word	item lexical	كلمة معجمية
vocal bands/cords/folds	corde vocales	أوتار صوتية
vocal characterizer	ton de la voix	نغمة الصوت
vocalic alternation	alternance vocalique	تعاقب المصوتات
vocalic consonant	consonne syllabique	صامت مقطعي
vocalic mimicry	mimique vocalique	إشمام
vocalism	vocalisme	-نظام المصوتات -نظام الحركات
vocalization	vocalisation	تحويل إلى مصوت
vocalized	voisé	مجهور
vocal qualifier	ton de la voix	نغمة الصوت
vocal tract	canal vocal ;appareil vocal	-جهاز صوتي -القناة الصوتية
vocatise case	cas vocatif	المنادى
voice	1-voix  2-voisement 3-voix du verbe	1-صوت الحنجرة 2-جهر 3-بناء للمعلوم أو المجهول
voiced	sonore ;voisé	مجهور
voiceless	non-voisé ;sourd	مهموس
voiceless vowel	voyelle non-voisée ; voyelle chuchotée	مصوت مهموس
voice quality	qualité de la voix	نوعية الصوت الحنجري
voice register	registre de la voix	سجل صوتي
voicing	voisement	إجهار
volume	ampleur de la voix	جرم الصوت
vowel	voyelle	مصوت
vowel attack/begining	attaque vocalique	استهلال (ابتداء الصوت)
vowel cluster	suite vocalique ;groupe vocalique	مجموعة منساقة  من المصوتات
vowel gradation	gradation vocalique	تعاقب المصوتات
vowel harmony/mutation	harmonie vocalique ;mutation vocalique	إتباع
vowel quadrilateral	schéma quadrilatéral pour voyelles	رسم رباعي  الأضلاع للمصوتات
vowelle quality	qualité vocalique	نوعية المصوتات
vowel quantity	-quantité vocalique -durée/longueur d’une voyelle	طول (أو مد) المصوت
vowel reduction	réduction de la voyelle	اختزال المصوت
vowel shift	mutation(changement) vocalique	تحول المصوتات
vowel system	systéme vocalique	نظام المصوتات
vowel triangla	triangle vocalique	الرسم المثلث للمصوتات
vulgar	vulgaire	-مبتذل -عامي
		
		
		
		
		
		
		
		
		
		
wave form	forme de l’onde(sonore)	شكل موجة
wave theory	théorie des ondes	نظرية الأمواج (اللغوية)
weakening	affaiblissement	إضعاف
weak stress	accent faible	نبر ضعيف
well-formed-sentence	phrase bien fermée	جملة سليمة
Wernich’s area	zone (aire) de Wernicke (du cerveau)	منطقة "فرنيكا" (في الدماغ)
whisper	chuchotement	-همس -وشوشة
whispered vowel	voyelle chuchotée ; voyelle non-voisée	مصوت مهموس
whisper state	état de chuchotement	حالة همس
whistling consonant	sifflante	صامت صفيري
whorfian hypothesis	hypotése de whorf	فرضية "وورف" (نسبية)
wide diphthong	diphthongue large	مصوت مزدوج متسع
widned meaning	sens élargi	معنى موسع
widening of meaning	extension du sens	اتساع المعنى
wide vowel	voyelle large	مصوت متسع
windpipe	trachée artére	قصبة الرئة
word	mot	كلمة
word and paradigm	mot-et-paradigme	العنصر وانتظامه (منهج تحليلي)
word boundary	frontiére de mot	حدود الكلمة
word class	classe de mot	جنس من أجناس  الكلم
word count	statistique lexicales	إحصاء المفردات
word crossing	fusion	انصهار (صياغة واحدة)
word form	forme grammaticale d’un mot	صيغة الكلمة  (النحوية)
word formation	formation des mots	صوغ الكلمة
word –for-word-translation	traduction mot à mot ; traduction littérale	ترجمة حرفية
word fréquency	fréquence du mot	-تواتر الكلمة (كثرتها في الخطاب) -شيوع الكلمة (كثرتها جغرافيا أي انتشارها)
word group	groupe des mots	مجموعة كلم
word list	liste des mots	رصيد لغوي
word order	ordre des mots	ترتيب الكلم
word paradigm	1-paradigme du mot 2-mot-et-paradigme	1-مثال 2-منهجبة الكلمة والتصريف
word display	mot-vedette ;vedette	-عنوان -باب
word sign	logogramme	هجاء تصويري
word stress	accent du mot	نبر الكلمة
wrenched accent	accent déformé	تطويح محرف
writer	scripteur	الكاتب (خلاف المتكلم)
writing	écriture	كتابة
writing system	système d’écriture	نظام الكتابة
written language	langue écrite	لغة مكتوبة
		
		
		
		
		
		
		
		
		
		
		
		
		
		
		
		
		
		
		
		
		
		
		
		
		
yodization	yodisation	تحويل إلى ياء
yo-he-ho theory	théorie yo-he-ho  (origine de la langue	نظرية اليوهيو (من نظريات نشأة اللغة)
young grammarians	néogramamrians	نحويون محدثون (مدرسة نحوية)
zero allomorph	allomorphe zéro	عدم البدل
zero anaphora	anaphore zéro	عدم الضمير العائد
zero connector	zéro connecteur	عدم الرابط
zero ending	désinence zéro	عدم العلامة  الإعرابية
zero mark	marque zéro	عدم الدالة المثالية
zeugma	zeugma	تبديل
zipf’s law	loi de zipf	قانون "زيف" (خاص بتوزيع وشيوع الكلمات)
zoo -semiotics	sémiotique animale	رسم الأدلة الحيوانية